"","Time","Price","Size","cum_volume","ppt"
"377",2018-12-17 10:15:38,29.1,22050,22050,1.37
"376",2018-12-17 10:16:27,29.1,500,22550,0.03
"375",2018-12-17 10:17:12,29.2,2000,24550,0.12
"374",2018-12-17 10:18:11,29.1,100,24650,0.01
"373",2018-12-17 10:18:51,29.1,170,24820,0.01
"372",2018-12-17 10:18:58,29.1,800,25620,0.05
"371",2018-12-17 10:19:17,29.15,20,25640,0
"370",2018-12-17 10:20:40,29.05,2600,28240,0.16
"369",2018-12-17 10:21:38,29.05,2000,30240,0.12
"368",2018-12-17 10:22:01,29.05,4700,34940,0.29
"367",2018-12-17 10:22:07,29.05,100,35040,0.01
"366",2018-12-17 10:22:39,29.1,150,35190,0.01
"365",2018-12-17 10:22:54,29.1,70,35260,0
"364",2018-12-17 10:23:13,29.1,780,36040,0.05
"363",2018-12-17 10:24:10,29.1,10,36050,0
"362",2018-12-17 10:24:17,29.05,3380,39430,0.21
"361",2018-12-17 10:24:26,29.05,1620,41050,0.1
"360",2018-12-17 10:24:38,29.05,150,41200,0.01
"359",2018-12-17 10:25:30,29.05,3060,44260,0.19
"358",2018-12-17 10:25:52,29.05,500,44760,0.03
"357",2018-12-17 10:27:25,29.05,10000,54760,0.62
"356",2018-12-17 10:27:29,29.1,500,55260,0.03
"355",2018-12-17 10:28:36,29.1,10,55270,0
"354",2018-12-17 10:29:15,29.1,500,55770,0.03
"353",2018-12-17 10:29:20,29.05,10,55780,0
"352",2018-12-17 10:29:39,29.05,1000,56780,0.06
"351",2018-12-17 10:30:22,29.05,10,56790,0
"350",2018-12-17 10:31:09,29.05,200,56990,0.01
"349",2018-12-17 10:31:31,29.05,300,57290,0.02
"348",2018-12-17 10:31:53,29.05,3810,61100,0.24
"347",2018-12-17 10:31:58,29.05,15000,76100,0.93
"346",2018-12-17 10:32:10,29.05,3890,79990,0.24
"345",2018-12-17 10:32:18,29.05,4110,84100,0.26
"344",2018-12-17 10:32:23,29.05,890,84990,0.06
"343",2018-12-17 10:32:35,29.05,110,85100,0.01
"342",2018-12-17 10:32:36,29.05,900,86000,0.06
"341",2018-12-17 10:32:39,29.05,750,86750,0.05
"340",2018-12-17 10:32:49,29,4500,91250,0.28
"339",2018-12-17 10:32:50,29,4000,95250,0.25
"338",2018-12-17 10:34:57,29,300,95550,0.02
"337",2018-12-17 10:35:17,29.05,100,95650,0.01
"336",2018-12-17 10:35:25,29,500,96150,0.03
"335",2018-12-17 10:36:49,29,800,96950,0.05
"334",2018-12-17 10:38:35,29,30,96980,0
"333",2018-12-17 10:39:17,29.05,200,97180,0.01
"332",2018-12-17 10:39:22,29.05,1000,98180,0.06
"331",2018-12-17 10:39:29,29.05,1920,100100,0.12
"330",2018-12-17 10:40:32,29.1,1000,101100,0.06
"329",2018-12-17 10:41:08,29.1,330,101430,0.02
"328",2018-12-17 10:41:33,29.1,17850,119280,1.11
"327",2018-12-17 10:41:48,29.1,20,119300,0
"326",2018-12-17 10:42:00,29.1,1200,120500,0.07
"325",2018-12-17 10:42:09,29.15,30,120530,0
"324",2018-12-17 10:42:22,29.1,700,121230,0.04
"323",2018-12-17 10:42:28,29.1,1000,122230,0.06
"322",2018-12-17 10:42:56,29.15,1060,123290,0.07
"321",2018-12-17 10:43:39,29.1,3000,126290,0.19
"320",2018-12-17 10:44:31,29.1,150,126440,0.01
"319",2018-12-17 10:45:31,29.1,100,126540,0.01
"318",2018-12-17 10:45:36,29.1,80,126620,0
"317",2018-12-17 10:45:40,29.1,50,126670,0
"316",2018-12-17 10:46:16,29.1,100,126770,0.01
"315",2018-12-17 10:47:20,29.1,110,126880,0.01
"314",2018-12-17 10:47:40,29.15,1000,127880,0.06
"313",2018-12-17 10:47:46,29.1,20,127900,0
"312",2018-12-17 10:49:13,29.1,250,128150,0.02
"311",2018-12-17 10:51:21,29.15,160,128310,0.01
"310",2018-12-17 10:51:44,29.15,3580,131890,0.22
"309",2018-12-17 10:52:02,29.15,500,132390,0.03
"308",2018-12-17 10:52:22,29.15,1500,133890,0.09
"307",2018-12-17 10:52:37,29.15,1650,135540,0.1
"306",2018-12-17 10:52:45,29.15,500,136040,0.03
"305",2018-12-17 10:53:01,29.15,2000,138040,0.12
"304",2018-12-17 10:53:20,29.15,2860,140900,0.18
"303",2018-12-17 10:54:09,29.2,50,140950,0
"302",2018-12-17 10:54:52,29.2,13420,154370,0.84
"301",2018-12-17 10:55:01,29.2,1200,155570,0.07
"300",2018-12-17 10:55:09,29.2,1800,157370,0.11
"299",2018-12-17 10:55:11,29.25,2600,159970,0.16
"298",2018-12-17 10:55:50,29.2,200,160170,0.01
"297",2018-12-17 10:56:26,29.25,7000,167170,0.44
"296",2018-12-17 10:56:28,29.2,1000,168170,0.06
"295",2018-12-17 10:57:09,29.2,90,168260,0.01
"294",2018-12-17 10:58:38,29.2,2490,170750,0.16
"293",2018-12-17 11:00:09,29.15,300,171050,0.02
"292",2018-12-17 11:01:23,29.2,10,171060,0
"291",2018-12-17 11:01:33,29.2,500,171560,0.03
"290",2018-12-17 11:02:06,29.2,20,171580,0
"289",2018-12-17 11:02:49,29.15,10,171590,0
"288",2018-12-17 11:03:04,29.15,20,171610,0
"287",2018-12-17 11:04:14,29.15,8640,180250,0.54
"286",2018-12-17 11:04:17,29.15,1000,181250,0.06
"285",2018-12-17 11:04:23,29.15,100,181350,0.01
"284",2018-12-17 11:07:55,29.15,400,181750,0.02
"283",2018-12-17 11:07:56,29.15,1700,183450,0.11
"282",2018-12-17 11:08:27,29.2,10000,193450,0.62
"281",2018-12-17 11:09:04,29.2,1810,195260,0.11
"280",2018-12-17 11:09:06,29.2,1540,196800,0.1
"279",2018-12-17 11:09:10,29.15,500,197300,0.03
"278",2018-12-17 11:09:26,29.2,10,197310,0
"277",2018-12-17 11:10:03,29.2,8170,205480,0.51
"276",2018-12-17 11:11:32,29.2,500,205980,0.03
"275",2018-12-17 11:12:22,29.2,3130,209110,0.2
"274",2018-12-17 11:12:29,29.2,510,209620,0.03
"273",2018-12-17 11:18:51,29.15,3000,212620,0.19
"272",2018-12-17 11:19:27,29.15,490,213110,0.03
"271",2018-12-17 11:19:44,29.15,23720,236830,1.48
"270",2018-12-17 11:20:26,29.15,3380,240210,0.21
"269",2018-12-17 11:20:39,29.15,2000,242210,0.12
"268",2018-12-17 11:23:07,29.15,500,242710,0.03
"267",2018-12-17 11:26:43,29.15,2000,244710,0.12
"266",2018-12-17 11:27:00,29.15,1170,245880,0.07
"265",2018-12-17 11:29:02,29.15,800,246680,0.05
"264",2018-12-17 11:29:04,29.15,5000,251680,0.31
"263",2018-12-17 11:29:59,29.1,3000,254680,0.19
"262",2018-12-17 11:30:51,29.15,2000,256680,0.12
"261",2018-12-17 11:31:18,29.15,5000,261680,0.31
"260",2018-12-17 11:31:24,29.15,1000,262680,0.06
"259",2018-12-17 11:32:36,29.1,200,262880,0.01
"258",2018-12-17 11:33:07,29.1,5000,267880,0.31
"257",2018-12-17 11:33:08,29.1,2500,270380,0.16
"256",2018-12-17 11:33:11,29.1,150,270530,0.01
"255",2018-12-17 11:33:14,29.1,7000,277530,0.44
"254",2018-12-17 11:33:16,29.1,4070,281600,0.25
"253",2018-12-17 11:33:44,29.05,7000,288600,0.44
"252",2018-12-17 11:35:08,29.05,800,289400,0.05
"251",2018-12-17 11:35:41,29.1,210,289610,0.01
"250",2018-12-17 11:35:45,29.1,8000,297610,0.5
"249",2018-12-17 11:35:53,29.1,1330,298940,0.08
"248",2018-12-17 11:36:35,29.1,1500,300440,0.09
"247",2018-12-17 11:37:15,29.05,20000,320440,1.25
"246",2018-12-17 11:37:27,29.05,100,320540,0.01
"245",2018-12-17 11:38:07,29.05,10100,330640,0.63
"244",2018-12-17 11:38:59,29.05,12590,343230,0.78
"243",2018-12-17 11:40:06,29.05,11300,354530,0.7
"242",2018-12-17 11:40:13,29.05,1110,355640,0.07
"241",2018-12-17 11:40:52,29.05,300,355940,0.02
"240",2018-12-17 11:41:11,29.05,160,356100,0.01
"239",2018-12-17 11:41:24,29.05,500,356600,0.03
"238",2018-12-17 11:42:16,29.05,160,356760,0.01
"237",2018-12-17 11:42:17,29.05,150,356910,0.01
"236",2018-12-17 11:42:23,29.05,920,357830,0.06
"235",2018-12-17 11:42:28,29.05,1200,359030,0.07
"234",2018-12-17 11:42:53,29,50000,409030,3.12
"233",2018-12-17 11:42:59,29,2890,411920,0.18
"232",2018-12-17 11:43:00,29,5000,416920,0.31
"231",2018-12-17 11:43:03,29.05,30,416950,0
"230",2018-12-17 11:43:43,29.05,20000,436950,1.25
"229",2018-12-17 11:44:24,29.05,400,437350,0.02
"228",2018-12-17 11:47:32,29.1,10000,447350,0.62
"227",2018-12-17 11:55:00,29.05,1000,448350,0.06
"226",2018-12-17 11:56:10,29.05,26000,474350,1.62
"225",2018-12-17 11:58:41,29.05,20,474370,0
"224",2018-12-17 11:59:16,29.05,6000,480370,0.37
"223",2018-12-17 12:01:12,29.05,100,480470,0.01
"222",2018-12-17 12:02:11,29.1,500,480970,0.03
"221",2018-12-17 12:02:45,29.1,5000,485970,0.31
"220",2018-12-17 12:02:53,29.1,1000,486970,0.06
"219",2018-12-17 12:03:19,29.1,500,487470,0.03
"218",2018-12-17 12:03:25,29.1,60,487530,0
"217",2018-12-17 12:04:03,29.1,7390,494920,0.46
"216",2018-12-17 12:04:06,29.1,12000,506920,0.75
"215",2018-12-17 12:05:34,29.1,4000,510920,0.25
"214",2018-12-17 12:06:29,29.1,280,511200,0.02
"213",2018-12-17 12:07:15,29.1,70,511270,0
"212",2018-12-17 12:07:30,29.1,140,511410,0.01
"211",2018-12-17 12:08:03,29.15,190,511600,0.01
"210",2018-12-17 12:08:07,29.15,100,511700,0.01
"209",2018-12-17 12:08:20,29.15,5000,516700,0.31
"208",2018-12-17 12:08:29,29.15,110,516810,0.01
"207",2018-12-17 12:08:41,29.1,100,516910,0.01
"206",2018-12-17 12:10:46,29.15,16330,533240,1.02
"205",2018-12-17 12:11:32,29.15,2000,535240,0.12
"204",2018-12-17 12:13:54,29.2,40,535280,0
"203",2018-12-17 12:14:58,29.2,50000,585280,3.12
"202",2018-12-17 12:17:34,29.2,12510,597790,0.78
"201",2018-12-17 12:17:40,29.2,4130,601920,0.26
"200",2018-12-17 12:17:45,29.2,1510,603430,0.09
"199",2018-12-17 12:18:16,29.2,4530,607960,0.28
"198",2018-12-17 12:20:48,29.2,1000,608960,0.06
"197",2018-12-17 12:21:12,29.2,1390,610350,0.09
"196",2018-12-17 12:22:04,29.15,20,610370,0
"195",2018-12-17 12:26:41,29.15,2090,612460,0.13
"194",2018-12-17 12:26:44,29.15,1000,613460,0.06
"193",2018-12-17 12:28:14,29.2,2000,615460,0.12
"192",2018-12-17 14:01:26,29.15,7000,622460,0.44
"191",2018-12-17 14:06:11,29.15,1000,623460,0.06
"190",2018-12-17 14:06:17,29.15,2000,625460,0.12
"189",2018-12-17 14:08:18,29.15,200,625660,0.01
"188",2018-12-17 14:08:49,29.15,500,626160,0.03
"187",2018-12-17 14:09:00,29.15,400,626560,0.02
"186",2018-12-17 14:09:11,29.15,4500,631060,0.28
"185",2018-12-17 14:09:20,29.15,1440,632500,0.09
"184",2018-12-17 14:09:46,29.15,1000,633500,0.06
"183",2018-12-17 14:09:57,29.15,2000,635500,0.12
"182",2018-12-17 14:10:00,29.15,3240,638740,0.2
"181",2018-12-17 14:10:20,29.15,50,638790,0
"180",2018-12-17 14:10:38,29.15,1510,640300,0.09
"179",2018-12-17 14:11:52,29.15,1000,641300,0.06
"178",2018-12-17 14:11:56,29.15,3490,644790,0.22
"177",2018-12-17 14:12:08,29.15,120,644910,0.01
"176",2018-12-17 14:13:00,29.15,4000,648910,0.25
"175",2018-12-17 14:13:08,29.15,1000,649910,0.06
"174",2018-12-17 14:13:22,29.15,1500,651410,0.09
"173",2018-12-17 14:13:43,29.15,700,652110,0.04
"172",2018-12-17 14:13:47,29.15,1000,653110,0.06
"171",2018-12-17 14:14:11,29.15,6000,659110,0.37
"170",2018-12-17 14:14:31,29.15,150,659260,0.01
"169",2018-12-17 14:14:34,29.15,1400,660660,0.09
"168",2018-12-17 14:15:04,29.1,20000,680660,1.25
"167",2018-12-17 14:15:31,29.1,3100,683760,0.19
"166",2018-12-17 14:16:11,29.1,500,684260,0.03
"165",2018-12-17 14:16:45,29.1,7940,692200,0.49
"164",2018-12-17 14:16:48,29.05,870,693070,0.05
"163",2018-12-17 14:17:18,29.05,3000,696070,0.19
"162",2018-12-17 14:17:48,29.1,100,696170,0.01
"161",2018-12-17 14:18:42,29.05,500,696670,0.03
"160",2018-12-17 14:18:46,29.05,1000,697670,0.06
"159",2018-12-17 14:19:31,29.05,2200,699870,0.14
"158",2018-12-17 14:19:47,29.05,50,699920,0
"157",2018-12-17 14:20:10,29.05,10000,709920,0.62
"156",2018-12-17 14:20:41,29.05,3000,712920,0.19
"155",2018-12-17 14:20:42,29.05,100,713020,0.01
"154",2018-12-17 14:21:21,29.05,780,713800,0.05
"153",2018-12-17 14:21:30,29,500,714300,0.03
"152",2018-12-17 14:21:39,29.05,1220,715520,0.08
"151",2018-12-17 14:22:11,29.05,1000,716520,0.06
"150",2018-12-17 14:24:10,29.05,4000,720520,0.25
"149",2018-12-17 14:24:37,29.05,500,721020,0.03
"148",2018-12-17 14:24:51,29.05,1000,722020,0.06
"147",2018-12-17 14:25:03,29.05,11280,733300,0.7
"146",2018-12-17 14:25:12,29.05,80,733380,0
"145",2018-12-17 14:25:43,29,3000,736380,0.19
"144",2018-12-17 14:25:57,29.05,3640,740020,0.23
"143",2018-12-17 14:26:03,29,1960,741980,0.12
"142",2018-12-17 14:26:04,29.1,140,742120,0.01
"141",2018-12-17 14:26:37,29,2600,744720,0.16
"140",2018-12-17 14:26:54,29,470,745190,0.03
"139",2018-12-17 14:27:07,29,1000,746190,0.06
"138",2018-12-17 14:27:41,29,9060,755250,0.56
"137",2018-12-17 14:27:52,29.05,5000,760250,0.31
"136",2018-12-17 14:27:56,29,500,760750,0.03
"135",2018-12-17 14:28:57,29,10000,770750,0.62
"134",2018-12-17 14:29:14,29,30,770780,0
"133",2018-12-17 14:30:01,29,60,770840,0
"132",2018-12-17 14:30:03,29,4000,774840,0.25
"131",2018-12-17 14:30:15,29,190,775030,0.01
"130",2018-12-17 14:30:40,29.05,50,775080,0
"129",2018-12-17 14:31:29,29.05,4000,779080,0.25
"128",2018-12-17 14:32:53,29.05,10,779090,0
"127",2018-12-17 14:33:55,29,40,779130,0
"126",2018-12-17 14:34:51,29,11000,790130,0.69
"125",2018-12-17 14:36:23,29.05,1000,791130,0.06
"124",2018-12-17 14:37:41,29,3000,794130,0.19
"123",2018-12-17 14:38:22,29,280,794410,0.02
"122",2018-12-17 14:39:15,29,30,794440,0
"121",2018-12-17 14:39:21,29,4860,799300,0.3
"120",2018-12-17 14:39:40,29,34130,833430,2.13
"119",2018-12-17 14:39:58,28.95,5700,839130,0.36
"118",2018-12-17 14:40:11,28.95,400,839530,0.02
"117",2018-12-17 14:40:16,28.95,5000,844530,0.31
"116",2018-12-17 14:41:00,28.95,20,844550,0
"115",2018-12-17 14:41:53,28.95,100,844650,0.01
"114",2018-12-17 14:41:55,28.95,400,845050,0.02
"113",2018-12-17 14:42:10,28.95,20,845070,0
"112",2018-12-17 14:42:15,28.95,5000,850070,0.31
"111",2018-12-17 14:42:30,28.95,1000,851070,0.06
"110",2018-12-17 14:42:37,28.95,2000,853070,0.12
"109",2018-12-17 14:43:16,28.95,1000,854070,0.06
"108",2018-12-17 14:43:17,28.95,500,854570,0.03
"107",2018-12-17 14:44:01,29,10000,864570,0.62
"106",2018-12-17 14:44:17,28.95,2000,866570,0.12
"105",2018-12-17 14:44:58,28.95,930,867500,0.06
"104",2018-12-17 14:45:29,28.95,20440,887940,1.27
"103",2018-12-17 14:45:32,28.95,6000,893940,0.37
"102",2018-12-17 14:45:40,28.95,8000,901940,0.5
"101",2018-12-17 14:45:42,28.95,1000,902940,0.06
"100",2018-12-17 14:46:03,28.9,1400,904340,0.09
"99",2018-12-17 14:46:24,28.9,2000,906340,0.12
"98",2018-12-17 14:47:14,28.95,7000,913340,0.44
"97",2018-12-17 14:49:00,28.95,6140,919480,0.38
"96",2018-12-17 14:49:05,28.95,1000,920480,0.06
"95",2018-12-17 14:49:18,28.95,3000,923480,0.19
"94",2018-12-17 14:49:22,28.95,3000,926480,0.19
"93",2018-12-17 14:49:24,28.95,8420,934900,0.52
"92",2018-12-17 14:52:09,29,200,935100,0.01
"91",2018-12-17 14:52:14,28.95,1000,936100,0.06
"90",2018-12-17 14:54:13,28.95,11000,947100,0.69
"89",2018-12-17 14:55:01,28.95,5000,952100,0.31
"88",2018-12-17 14:55:10,29,30650,982750,1.91
"87",2018-12-17 14:55:29,28.95,1000,983750,0.06
"86",2018-12-17 14:55:50,29.05,6770,990520,0.42
"85",2018-12-17 14:57:04,29.05,1000,991520,0.06
"84",2018-12-17 14:58:55,29.05,50,991570,0
"83",2018-12-17 14:59:47,29.1,2000,993570,0.12
"82",2018-12-17 15:00:04,29.1,1000,994570,0.06
"81",2018-12-17 15:00:39,29.1,2000,996570,0.12
"80",2018-12-17 15:00:47,29.1,100,996670,0.01
"79",2018-12-17 15:00:50,29.15,500,997170,0.03
"78",2018-12-17 15:04:40,29.15,2000,999170,0.12
"77",2018-12-17 15:06:26,29.15,1180,1000350,0.07
"76",2018-12-17 15:06:33,29.1,4840,1005190,0.3
"75",2018-12-17 15:06:34,29.1,3000,1008190,0.19
"74",2018-12-17 15:06:43,29.1,2160,1010350,0.13
"73",2018-12-17 15:07:00,29.1,840,1011190,0.05
"72",2018-12-17 15:07:14,29.1,500,1011690,0.03
"71",2018-12-17 15:07:53,29.1,5000,1016690,0.31
"70",2018-12-17 15:08:05,29.1,3190,1019880,0.2
"69",2018-12-17 15:09:41,29.1,1820,1021700,0.11
"68",2018-12-17 15:09:49,29.05,4000,1025700,0.25
"67",2018-12-17 15:10:04,29.05,46680,1072380,2.91
"66",2018-12-17 15:10:14,29.05,3320,1075700,0.21
"65",2018-12-17 15:10:27,29.05,3000,1078700,0.19
"64",2018-12-17 15:13:09,29.05,5000,1083700,0.31
"63",2018-12-17 15:15:12,29,20000,1103700,1.25
"62",2018-12-17 15:15:23,29.05,1500,1105200,0.09
"61",2018-12-17 15:15:28,29.05,1000,1106200,0.06
"60",2018-12-17 15:16:09,29.05,2500,1108700,0.16
"59",2018-12-17 15:16:39,29.05,200,1108900,0.01
"58",2018-12-17 15:17:09,29.05,1300,1110200,0.08
"57",2018-12-17 15:17:36,29.05,5000,1115200,0.31
"56",2018-12-17 15:17:43,29.05,3900,1119100,0.24
"55",2018-12-17 15:17:54,29,1000,1120100,0.06
"54",2018-12-17 15:18:06,29,2000,1122100,0.12
"53",2018-12-17 15:18:19,29,110,1122210,0.01
"52",2018-12-17 15:18:26,29.05,2000,1124210,0.12
"51",2018-12-17 15:18:39,29,7900,1132110,0.49
"50",2018-12-17 15:18:40,29.05,2950,1135060,0.18
"49",2018-12-17 15:18:43,29.05,1650,1136710,0.1
"48",2018-12-17 15:18:59,29.05,400,1137110,0.02
"47",2018-12-17 15:19:01,29.05,620,1137730,0.04
"46",2018-12-17 15:19:24,29,2800,1140530,0.17
"45",2018-12-17 15:19:26,29,100,1140630,0.01
"44",2018-12-17 15:19:44,29,10000,1150630,0.62
"43",2018-12-17 15:20:09,29,1000,1151630,0.06
"42",2018-12-17 15:20:22,29,5000,1156630,0.31
"41",2018-12-17 15:20:43,29,1000,1157630,0.06
"40",2018-12-17 15:20:59,28.95,2500,1160130,0.16
"39",2018-12-17 15:21:14,28.95,9950,1170080,0.62
"38",2018-12-17 15:21:16,29,1000,1171080,0.06
"37",2018-12-17 15:21:33,29,3000,1174080,0.19
"36",2018-12-17 15:21:49,28.9,70800,1244880,4.41
"35",2018-12-17 15:21:54,28.85,170,1245050,0.01
"34",2018-12-17 15:21:56,28.85,30,1245080,0
"33",2018-12-17 15:21:59,28.9,7000,1252080,0.44
"32",2018-12-17 15:22:17,28.9,2000,1254080,0.12
"31",2018-12-17 15:23:08,28.9,10,1254090,0
"30",2018-12-17 15:23:24,28.85,3000,1257090,0.19
"29",2018-12-17 15:23:59,28.85,20,1257110,0
"28",2018-12-17 15:24:13,28.85,5000,1262110,0.31
"27",2018-12-17 15:24:35,28.85,8480,1270590,0.53
"26",2018-12-17 15:24:45,28.9,4400,1274990,0.27
"25",2018-12-17 15:24:46,28.8,200,1275190,0.01
"24",2018-12-17 15:24:57,28.8,20000,1295190,1.25
"23",2018-12-17 15:25:06,28.8,3500,1298690,0.22
"22",2018-12-17 15:25:31,28.8,1700,1300390,0.11
"21",2018-12-17 15:26:15,28.8,500,1300890,0.03
"20",2018-12-17 15:26:19,28.8,440,1301330,0.03
"19",2018-12-17 15:26:22,28.85,400,1301730,0.02
"18",2018-12-17 15:26:25,28.9,20220,1321950,1.26
"17",2018-12-17 15:26:33,28.9,100,1322050,0.01
"16",2018-12-17 15:27:19,28.85,10100,1332150,0.63
"15",2018-12-17 15:27:25,28.8,1000,1333150,0.06
"14",2018-12-17 15:27:42,28.85,70,1333220,0
"13",2018-12-17 15:27:45,28.85,2730,1335950,0.17
"12",2018-12-17 15:27:52,28.8,1320,1337270,0.08
"11",2018-12-17 15:27:56,28.8,11950,1349220,0.74
"10",2018-12-17 15:28:00,28.8,100,1349320,0.01
"9",2018-12-17 15:28:14,28.7,250,1349570,0.02
"8",2018-12-17 15:28:37,28.7,4500,1354070,0.28
"7",2018-12-17 15:28:41,28.7,10000,1364070,0.62
"6",2018-12-17 15:28:53,28.7,500,1364570,0.03
"5",2018-12-17 15:29:22,28.8,10000,1374570,0.62
"4",2018-12-17 15:29:33,28.7,4110,1378680,0.26
"3",2018-12-17 15:29:38,28.7,100,1378780,0.01
"2",2018-12-17 15:29:57,28.7,10,1378790,0
"1",2018-12-17 15:47:13,28.55,225830,1604620,14.07
"546",2018-12-18 10:15:44,27.8,130500,130500,6.61
"545",2018-12-18 10:15:51,28,300,130800,0.02
"544",2018-12-18 10:15:53,27.8,5000,135800,0.25
"543",2018-12-18 10:16:03,28,10200,146000,0.52
"542",2018-12-18 10:16:10,27.85,20000,166000,1.01
"541",2018-12-18 10:16:15,28,19520,185520,0.99
"540",2018-12-18 10:16:31,28.2,8000,193520,0.4
"539",2018-12-18 10:16:40,28,3000,196520,0.15
"538",2018-12-18 10:17:05,28,2000,198520,0.1
"537",2018-12-18 10:17:20,28.1,10,198530,0
"536",2018-12-18 10:17:24,28.1,9990,208520,0.51
"535",2018-12-18 10:17:48,28.1,110,208630,0.01
"534",2018-12-18 10:17:52,28.1,700,209330,0.04
"533",2018-12-18 10:18:02,28.5,125010,334340,6.33
"532",2018-12-18 10:18:09,28.5,11100,345440,0.56
"531",2018-12-18 10:18:15,28.5,350,345790,0.02
"530",2018-12-18 10:18:51,28.1,50,345840,0
"529",2018-12-18 10:18:58,28.1,8750,354590,0.44
"528",2018-12-18 10:19:12,28.1,20,354610,0
"527",2018-12-18 10:19:16,28.1,100,354710,0.01
"526",2018-12-18 10:19:17,28.1,200,354910,0.01
"525",2018-12-18 10:19:22,28.1,2280,357190,0.12
"524",2018-12-18 10:19:23,28.1,2450,359640,0.12
"523",2018-12-18 10:19:43,28.2,20,359660,0
"522",2018-12-18 10:19:49,28.2,1000,360660,0.05
"521",2018-12-18 10:20:23,28.2,1010,361670,0.05
"520",2018-12-18 10:20:37,28.1,8000,369670,0.4
"519",2018-12-18 10:20:40,28.1,2000,371670,0.1
"518",2018-12-18 10:20:54,28.2,50,371720,0
"517",2018-12-18 10:21:29,28.2,1000,372720,0.05
"516",2018-12-18 10:21:32,28.2,500,373220,0.03
"515",2018-12-18 10:22:11,28.15,250,373470,0.01
"514",2018-12-18 10:22:27,28.2,1000,374470,0.05
"513",2018-12-18 10:22:32,28.15,800,375270,0.04
"512",2018-12-18 10:22:47,28.2,500,375770,0.03
"511",2018-12-18 10:23:02,28.15,200,375970,0.01
"510",2018-12-18 10:23:06,28.2,150,376120,0.01
"509",2018-12-18 10:23:43,28.2,3000,379120,0.15
"508",2018-12-18 10:23:48,28.15,1230,380350,0.06
"507",2018-12-18 10:23:53,28.15,1000,381350,0.05
"506",2018-12-18 10:23:56,28.2,5070,386420,0.26
"505",2018-12-18 10:24:18,28.2,10,386430,0
"504",2018-12-18 10:24:32,28.2,2000,388430,0.1
"503",2018-12-18 10:24:37,28.2,70,388500,0
"502",2018-12-18 10:24:39,28.2,3810,392310,0.19
"501",2018-12-18 10:24:40,28.2,2810,395120,0.14
"500",2018-12-18 10:25:03,28.2,3290,398410,0.17
"499",2018-12-18 10:25:25,28.2,1710,400120,0.09
"498",2018-12-18 10:25:51,28.25,4000,404120,0.2
"497",2018-12-18 10:26:40,28.3,1000,405120,0.05
"496",2018-12-18 10:26:46,28.3,250,405370,0.01
"495",2018-12-18 10:26:47,28.25,2000,407370,0.1
"494",2018-12-18 10:26:51,28.3,4150,411520,0.21
"493",2018-12-18 10:27:00,28.3,500,412020,0.03
"492",2018-12-18 10:27:06,28.3,350,412370,0.02
"491",2018-12-18 10:27:18,28.25,100,412470,0.01
"490",2018-12-18 10:27:23,28.25,9100,421570,0.46
"489",2018-12-18 10:27:25,28.25,900,422470,0.05
"488",2018-12-18 10:27:45,28.25,100,422570,0.01
"487",2018-12-18 10:27:51,28.3,2000,424570,0.1
"486",2018-12-18 10:28:07,28.25,50,424620,0
"485",2018-12-18 10:28:18,28.25,750,425370,0.04
"484",2018-12-18 10:28:38,28.25,1750,427120,0.09
"483",2018-12-18 10:29:05,28.25,30,427150,0
"482",2018-12-18 10:29:12,28.2,900,428050,0.05
"481",2018-12-18 10:29:25,28.25,500,428550,0.03
"480",2018-12-18 10:30:05,28.2,20,428570,0
"479",2018-12-18 10:30:20,28.2,1400,429970,0.07
"478",2018-12-18 10:30:27,28.2,10000,439970,0.51
"477",2018-12-18 10:30:38,28.2,7120,447090,0.36
"476",2018-12-18 10:30:44,28.2,3580,450670,0.18
"475",2018-12-18 10:30:55,28.2,500,451170,0.03
"474",2018-12-18 10:31:30,28.25,2000,453170,0.1
"473",2018-12-18 10:31:53,28.25,200,453370,0.01
"472",2018-12-18 10:31:57,28.25,20,453390,0
"471",2018-12-18 10:32:56,28.25,360,453750,0.02
"470",2018-12-18 10:33:07,28.3,20,453770,0
"469",2018-12-18 10:34:00,28.25,1000,454770,0.05
"468",2018-12-18 10:34:02,28.3,20,454790,0
"467",2018-12-18 10:34:04,28.25,1070,455860,0.05
"466",2018-12-18 10:34:08,28.25,280,456140,0.01
"465",2018-12-18 10:34:29,28.3,800,456940,0.04
"464",2018-12-18 10:34:30,28.25,370,457310,0.02
"463",2018-12-18 10:34:46,28.25,1890,459200,0.1
"462",2018-12-18 10:34:51,28.2,10,459210,0
"461",2018-12-18 10:35:10,28.25,1000,460210,0.05
"460",2018-12-18 10:36:14,28.2,10000,470210,0.51
"459",2018-12-18 10:36:22,28.25,200,470410,0.01
"458",2018-12-18 10:37:11,28.25,5000,475410,0.25
"457",2018-12-18 10:37:13,28.25,790,476200,0.04
"456",2018-12-18 10:37:15,28.2,1000,477200,0.05
"455",2018-12-18 10:37:26,28.25,500,477700,0.03
"454",2018-12-18 10:37:42,28.25,2000,479700,0.1
"453",2018-12-18 10:37:48,28.2,170,479870,0.01
"452",2018-12-18 10:37:56,28.25,7620,487490,0.39
"451",2018-12-18 10:38:08,28.3,7800,495290,0.39
"450",2018-12-18 10:38:09,28.25,600,495890,0.03
"449",2018-12-18 10:38:28,28.25,8190,504080,0.41
"448",2018-12-18 10:38:40,28.25,2000,506080,0.1
"447",2018-12-18 10:41:07,28.3,10,506090,0
"446",2018-12-18 10:41:25,28.25,2000,508090,0.1
"445",2018-12-18 10:41:26,28.3,20,508110,0
"444",2018-12-18 10:41:31,28.3,2000,510110,0.1
"443",2018-12-18 10:42:22,28.3,16680,526790,0.84
"442",2018-12-18 10:42:35,28.3,3320,530110,0.17
"441",2018-12-18 10:42:46,28.3,4180,534290,0.21
"440",2018-12-18 10:42:55,28.3,10000,544290,0.51
"439",2018-12-18 10:43:55,28.3,5000,549290,0.25
"438",2018-12-18 10:45:00,28.3,500,549790,0.03
"437",2018-12-18 10:47:01,28.35,19500,569290,0.99
"436",2018-12-18 10:47:15,28.35,2000,571290,0.1
"435",2018-12-18 10:47:18,28.35,500,571790,0.03
"434",2018-12-18 10:47:39,28.4,1000,572790,0.05
"433",2018-12-18 10:47:40,28.35,5000,577790,0.25
"432",2018-12-18 10:47:44,28.35,1300,579090,0.07
"431",2018-12-18 10:47:56,28.35,1000,580090,0.05
"430",2018-12-18 10:48:07,28.35,9880,589970,0.5
"429",2018-12-18 10:48:30,28.35,3000,592970,0.15
"428",2018-12-18 10:48:40,28.4,320,593290,0.02
"427",2018-12-18 10:48:43,28.4,2000,595290,0.1
"426",2018-12-18 10:49:03,28.4,1000,596290,0.05
"425",2018-12-18 10:50:39,28.4,5000,601290,0.25
"424",2018-12-18 10:50:56,28.4,4000,605290,0.2
"423",2018-12-18 10:51:14,28.4,100,605390,0.01
"422",2018-12-18 10:51:21,28.4,8910,614300,0.45
"421",2018-12-18 10:51:29,28.4,1000,615300,0.05
"420",2018-12-18 10:51:52,28.4,7020,622320,0.36
"419",2018-12-18 10:52:17,28.4,2260,624580,0.11
"418",2018-12-18 10:52:25,28.4,100,624680,0.01
"417",2018-12-18 10:52:30,28.4,1000,625680,0.05
"416",2018-12-18 10:52:36,28.4,1640,627320,0.08
"415",2018-12-18 10:53:12,28.45,14000,641320,0.71
"414",2018-12-18 10:53:41,28.45,1740,643060,0.09
"413",2018-12-18 10:53:43,28.45,10,643070,0
"412",2018-12-18 10:53:47,28.45,390,643460,0.02
"411",2018-12-18 10:54:19,28.5,4600,648060,0.23
"410",2018-12-18 10:54:23,28.45,500,648560,0.03
"409",2018-12-18 10:54:39,28.5,8410,656970,0.43
"408",2018-12-18 10:54:46,28.5,500,657470,0.03
"407",2018-12-18 10:54:48,28.5,400,657870,0.02
"406",2018-12-18 10:54:55,28.5,500,658370,0.03
"405",2018-12-18 10:55:04,28.5,3000,661370,0.15
"404",2018-12-18 10:55:30,28.5,5000,666370,0.25
"403",2018-12-18 10:55:37,28.5,1000,667370,0.05
"402",2018-12-18 10:55:48,28.5,18730,686100,0.95
"401",2018-12-18 10:55:51,28.5,5000,691100,0.25
"400",2018-12-18 10:55:56,28.5,9310,700410,0.47
"399",2018-12-18 10:57:34,28.5,500,700910,0.03
"398",2018-12-18 10:58:06,28.55,30,700940,0
"397",2018-12-18 10:58:36,28.55,350,701290,0.02
"396",2018-12-18 10:58:39,28.55,100,701390,0.01
"395",2018-12-18 10:58:42,28.55,400,701790,0.02
"394",2018-12-18 10:58:59,28.55,200,701990,0.01
"393",2018-12-18 10:59:12,28.55,20000,721990,1.01
"392",2018-12-18 10:59:16,28.55,3000,724990,0.15
"391",2018-12-18 10:59:19,28.55,890,725880,0.05
"390",2018-12-18 10:59:27,28.55,1290,727170,0.07
"389",2018-12-18 10:59:56,28.55,260,727430,0.01
"388",2018-12-18 11:00:00,28.55,530,727960,0.03
"387",2018-12-18 11:00:59,28.5,20,727980,0
"386",2018-12-18 11:01:08,28.5,3000,730980,0.15
"385",2018-12-18 11:01:09,28.55,10,730990,0
"384",2018-12-18 11:01:22,28.5,500,731490,0.03
"383",2018-12-18 11:01:23,28.55,1000,732490,0.05
"382",2018-12-18 11:02:03,28.55,10,732500,0
"381",2018-12-18 11:02:05,28.5,1000,733500,0.05
"380",2018-12-18 11:02:21,28.5,1060,734560,0.05
"379",2018-12-18 11:02:30,28.5,3000,737560,0.15
"378",2018-12-18 11:02:35,28.5,1800,739360,0.09
"3771",2018-12-18 11:02:37,28.5,1000,740360,0.05
"3761",2018-12-18 11:02:53,28.5,220,740580,0.01
"3751",2018-12-18 11:03:12,28.5,200,740780,0.01
"3741",2018-12-18 11:03:13,28.5,490,741270,0.02
"3731",2018-12-18 11:03:14,28.5,10,741280,0
"3721",2018-12-18 11:03:16,28.5,190,741470,0.01
"3711",2018-12-18 11:03:42,28.45,1000,742470,0.05
"3701",2018-12-18 11:04:05,28.45,1500,743970,0.08
"3691",2018-12-18 11:04:14,28.45,1000,744970,0.05
"3681",2018-12-18 11:04:20,28.45,27800,772770,1.41
"3671",2018-12-18 11:04:45,28.4,3500,776270,0.18
"3661",2018-12-18 11:05:06,28.4,1500,777770,0.08
"3651",2018-12-18 11:05:19,28.4,6280,784050,0.32
"3641",2018-12-18 11:05:24,28.4,2060,786110,0.1
"3631",2018-12-18 11:05:32,28.4,1000,787110,0.05
"3621",2018-12-18 11:05:34,28.35,10000,797110,0.51
"3611",2018-12-18 11:05:51,28.35,1000,798110,0.05
"3601",2018-12-18 11:05:55,28.3,6770,804880,0.34
"3591",2018-12-18 11:05:58,28.35,5000,809880,0.25
"3581",2018-12-18 11:06:20,28.3,1000,810880,0.05
"3571",2018-12-18 11:07:23,28.3,6000,816880,0.3
"3561",2018-12-18 11:07:32,28.3,3000,819880,0.15
"3551",2018-12-18 11:08:06,28.3,4000,823880,0.2
"3541",2018-12-18 11:08:44,28.3,8000,831880,0.4
"3531",2018-12-18 11:09:22,28.35,100,831980,0.01
"3521",2018-12-18 11:09:23,28.3,1000,832980,0.05
"3511",2018-12-18 11:09:26,28.3,3000,835980,0.15
"3501",2018-12-18 11:09:51,28.3,500,836480,0.03
"3491",2018-12-18 11:10:05,28.3,3070,839550,0.16
"3481",2018-12-18 11:11:20,28.3,3000,842550,0.15
"3471",2018-12-18 11:11:47,28.3,500,843050,0.03
"3461",2018-12-18 11:12:15,28.3,90,843140,0
"3451",2018-12-18 11:13:08,28.3,500,843640,0.03
"3441",2018-12-18 11:13:38,28.35,5000,848640,0.25
"3431",2018-12-18 11:14:57,28.3,1290,849930,0.07
"3421",2018-12-18 11:16:31,28.3,300,850230,0.02
"3411",2018-12-18 11:17:09,28.3,100,850330,0.01
"3401",2018-12-18 11:17:30,28.3,2000,852330,0.1
"3391",2018-12-18 11:17:34,28.3,1000,853330,0.05
"3381",2018-12-18 11:17:37,28.3,40,853370,0
"3371",2018-12-18 11:18:02,28.3,300,853670,0.02
"3361",2018-12-18 11:18:26,28.3,200,853870,0.01
"3351",2018-12-18 11:18:28,28.3,800,854670,0.04
"3341",2018-12-18 11:19:01,28.3,2000,856670,0.1
"3331",2018-12-18 11:19:30,28.3,200,856870,0.01
"3321",2018-12-18 11:21:34,28.35,100,856970,0.01
"3311",2018-12-18 11:22:46,28.35,1000,857970,0.05
"3301",2018-12-18 11:23:38,28.35,1100,859070,0.06
"3291",2018-12-18 11:23:50,28.35,4000,863070,0.2
"3281",2018-12-18 11:23:55,28.35,2000,865070,0.1
"3271",2018-12-18 11:24:03,28.35,1000,866070,0.05
"3261",2018-12-18 11:26:05,28.25,6330,872400,0.32
"3251",2018-12-18 11:26:11,28.25,20,872420,0
"3241",2018-12-18 11:27:49,28.25,5000,877420,0.25
"3231",2018-12-18 11:29:10,28.35,250,877670,0.01
"3221",2018-12-18 11:30:48,28.35,1630,879300,0.08
"3211",2018-12-18 11:31:23,28.35,60,879360,0
"3201",2018-12-18 11:32:04,28.35,310,879670,0.02
"3191",2018-12-18 11:32:11,28.35,60,879730,0
"3181",2018-12-18 11:32:28,28.35,2630,882360,0.13
"3171",2018-12-18 11:34:00,28.35,2000,884360,0.1
"3161",2018-12-18 11:35:18,28.35,10,884370,0
"3151",2018-12-18 11:35:29,28.35,1500,885870,0.08
"3141",2018-12-18 11:35:34,28.35,3860,889730,0.2
"3131",2018-12-18 11:36:25,28.35,100,889830,0.01
"3121",2018-12-18 11:37:57,28.35,30,889860,0
"3111",2018-12-18 11:40:57,28.3,10000,899860,0.51
"3101",2018-12-18 11:41:30,28.3,6170,906030,0.31
"3091",2018-12-18 11:43:35,28.3,100,906130,0.01
"3081",2018-12-18 11:44:19,28.25,1010,907140,0.05
"3071",2018-12-18 11:46:18,28.25,3000,910140,0.15
"3061",2018-12-18 11:46:19,28.25,2000,912140,0.1
"3051",2018-12-18 11:46:21,28.25,10000,922140,0.51
"3041",2018-12-18 11:46:30,28.25,1600,923740,0.08
"3031",2018-12-18 11:46:52,28.25,100,923840,0.01
"3021",2018-12-18 11:47:17,28.25,5000,928840,0.25
"3011",2018-12-18 11:47:36,28.25,1000,929840,0.05
"3001",2018-12-18 11:48:07,28.25,70,929910,0
"2991",2018-12-18 11:48:45,28.25,200,930110,0.01
"2981",2018-12-18 11:48:47,28.25,2000,932110,0.1
"2971",2018-12-18 11:49:32,28.25,10,932120,0
"2961",2018-12-18 11:50:36,28.2,6000,938120,0.3
"2951",2018-12-18 11:51:44,28.2,21930,960050,1.11
"2941",2018-12-18 11:53:05,28.15,2000,962050,0.1
"2931",2018-12-18 11:53:15,28.15,1000,963050,0.05
"2921",2018-12-18 11:53:35,28.15,3000,966050,0.15
"2911",2018-12-18 11:53:54,28.15,1000,967050,0.05
"2901",2018-12-18 11:53:56,28.15,2000,969050,0.1
"2891",2018-12-18 11:54:12,28.15,4500,973550,0.23
"2881",2018-12-18 11:54:14,28.15,1210,974760,0.06
"2871",2018-12-18 11:54:20,28.15,1330,976090,0.07
"2861",2018-12-18 11:54:36,28.1,2000,978090,0.1
"2851",2018-12-18 11:54:44,28.1,5000,983090,0.25
"2841",2018-12-18 11:54:46,28.1,2990,986080,0.15
"2831",2018-12-18 11:55:34,28.1,1000,987080,0.05
"2821",2018-12-18 11:55:46,28.15,200,987280,0.01
"2811",2018-12-18 11:55:49,28.1,120,987400,0.01
"2801",2018-12-18 11:55:56,28.1,70,987470,0
"2791",2018-12-18 11:56:19,28.15,1470,988940,0.07
"2781",2018-12-18 11:56:29,28.15,100,989040,0.01
"2771",2018-12-18 11:57:16,28.1,9310,998350,0.47
"2761",2018-12-18 11:59:01,28.15,70,998420,0
"2751",2018-12-18 11:59:26,28.1,150,998570,0.01
"2741",2018-12-18 11:59:31,28.1,500,999070,0.03
"2731",2018-12-18 12:01:48,28.15,3000,1002070,0.15
"2721",2018-12-18 12:02:14,28.1,2330,1004400,0.12
"2711",2018-12-18 12:02:19,28.1,5000,1009400,0.25
"2701",2018-12-18 12:03:02,28.1,10,1009410,0
"2691",2018-12-18 12:03:10,28.1,100,1009510,0.01
"2681",2018-12-18 12:03:23,28.1,2000,1011510,0.1
"2671",2018-12-18 12:03:28,28.1,60,1011570,0
"2661",2018-12-18 12:03:43,28.1,12970,1024540,0.66
"2651",2018-12-18 12:03:48,28.1,30,1024570,0
"2641",2018-12-18 12:06:40,28.1,180,1024750,0.01
"2631",2018-12-18 12:07:05,28.1,100,1024850,0.01
"2621",2018-12-18 12:08:53,28.1,2000,1026850,0.1
"2611",2018-12-18 12:09:08,28.1,3000,1029850,0.15
"2601",2018-12-18 12:09:43,28.1,8000,1037850,0.4
"2591",2018-12-18 12:10:40,28.15,2000,1039850,0.1
"2581",2018-12-18 12:11:05,28.05,5000,1044850,0.25
"2571",2018-12-18 12:11:41,28.15,8030,1052880,0.41
"2561",2018-12-18 12:11:43,28.15,1970,1054850,0.1
"2551",2018-12-18 12:12:28,28.1,30,1054880,0
"2541",2018-12-18 12:12:35,28.05,10,1054890,0
"2531",2018-12-18 12:13:37,28.1,800,1055690,0.04
"2521",2018-12-18 12:13:49,28.1,2000,1057690,0.1
"2511",2018-12-18 12:13:59,28.1,30,1057720,0
"2501",2018-12-18 12:14:22,28.1,200,1057920,0.01
"2491",2018-12-18 12:14:45,28.1,10000,1067920,0.51
"2481",2018-12-18 12:14:48,28.15,30,1067950,0
"2471",2018-12-18 12:15:01,28.1,500,1068450,0.03
"2461",2018-12-18 12:16:43,28.1,100,1068550,0.01
"2451",2018-12-18 12:17:36,28.1,300,1068850,0.02
"2441",2018-12-18 12:17:38,28.1,2000,1070850,0.1
"2431",2018-12-18 12:19:16,28.1,500,1071350,0.03
"2421",2018-12-18 12:20:40,28.05,20000,1091350,1.01
"2411",2018-12-18 12:20:43,28.15,200,1091550,0.01
"2401",2018-12-18 12:22:13,28.15,500,1092050,0.03
"2391",2018-12-18 12:22:33,28.15,100,1092150,0.01
"2381",2018-12-18 12:23:04,28.1,5000,1097150,0.25
"2371",2018-12-18 12:23:08,28.1,10,1097160,0
"2361",2018-12-18 12:23:24,28.1,200,1097360,0.01
"2351",2018-12-18 12:23:55,28.1,4790,1102150,0.24
"2341",2018-12-18 12:25:03,28.1,100,1102250,0.01
"2331",2018-12-18 12:25:07,28.1,120,1102370,0.01
"2321",2018-12-18 12:25:15,28.1,80,1102450,0
"2311",2018-12-18 12:25:21,28.1,120,1102570,0.01
"2301",2018-12-18 12:25:47,28.1,3880,1106450,0.2
"2291",2018-12-18 12:27:06,28.1,250,1106700,0.01
"2281",2018-12-18 12:27:15,28.1,870,1107570,0.04
"2271",2018-12-18 12:27:26,28.1,100,1107670,0.01
"2261",2018-12-18 12:28:21,28.1,400,1108070,0.02
"2251",2018-12-18 12:28:54,28.1,600,1108670,0.03
"2241",2018-12-18 12:29:05,28.15,100,1108770,0.01
"2231",2018-12-18 12:29:40,28.1,6180,1114950,0.31
"2221",2018-12-18 12:29:55,28.05,300,1115250,0.02
"2211",2018-12-18 12:29:58,28.1,200,1115450,0.01
"2201",2018-12-18 12:30:05,28.15,20000,1135450,1.01
"2191",2018-12-18 14:01:22,28.1,24640,1160090,1.25
"2181",2018-12-18 14:03:12,28.1,1500,1161590,0.08
"2171",2018-12-18 14:03:19,28.1,1290,1162880,0.07
"2161",2018-12-18 14:03:43,28.05,5000,1167880,0.25
"2151",2018-12-18 14:03:59,28.1,100,1167980,0.01
"2141",2018-12-18 14:04:10,28.05,7000,1174980,0.35
"2131",2018-12-18 14:05:17,28.1,680,1175660,0.03
"2121",2018-12-18 14:05:34,28.1,500,1176160,0.03
"2111",2018-12-18 14:05:45,28.1,5000,1181160,0.25
"2101",2018-12-18 14:06:07,28.1,200,1181360,0.01
"2091",2018-12-18 14:06:09,28.1,3620,1184980,0.18
"2081",2018-12-18 14:07:53,28.05,260,1185240,0.01
"2071",2018-12-18 14:08:35,28.05,2000,1187240,0.1
"2061",2018-12-18 14:08:46,28.1,10,1187250,0
"2051",2018-12-18 14:09:34,28.05,3000,1190250,0.15
"2041",2018-12-18 14:10:01,28.05,200,1190450,0.01
"2031",2018-12-18 14:10:08,28.05,2000,1192450,0.1
"2021",2018-12-18 14:10:48,28.05,5000,1197450,0.25
"2011",2018-12-18 14:11:04,28.05,480,1197930,0.02
"2001",2018-12-18 14:11:19,28.05,20000,1217930,1.01
"1991",2018-12-18 14:11:34,28.05,12320,1230250,0.62
"1981",2018-12-18 14:11:49,28.05,880,1231130,0.04
"1971",2018-12-18 14:12:41,28.05,530,1231660,0.03
"1961",2018-12-18 14:12:58,28.05,20,1231680,0
"1951",2018-12-18 14:13:56,28.05,10,1231690,0
"1941",2018-12-18 14:17:27,28.05,11770,1243460,0.6
"1931",2018-12-18 14:17:32,28,10000,1253460,0.51
"1921",2018-12-18 14:17:55,28.05,9700,1263160,0.49
"1911",2018-12-18 14:18:23,28.05,300,1263460,0.02
"1901",2018-12-18 14:18:26,28.05,350,1263810,0.02
"1891",2018-12-18 14:19:18,28,27700,1291510,1.4
"1881",2018-12-18 14:19:26,28,1000,1292510,0.05
"1871",2018-12-18 14:19:31,28,5000,1297510,0.25
"1861",2018-12-18 14:19:48,28,4000,1301510,0.2
"1851",2018-12-18 14:19:54,28,1000,1302510,0.05
"1841",2018-12-18 14:20:04,28,1500,1304010,0.08
"1831",2018-12-18 14:20:39,28,2900,1306910,0.15
"1821",2018-12-18 14:20:41,28.05,10500,1317410,0.53
"1811",2018-12-18 14:20:49,28.05,1000,1318410,0.05
"1801",2018-12-18 14:21:20,28.05,500,1318910,0.03
"1791",2018-12-18 14:21:25,28.05,2000,1320910,0.1
"1781",2018-12-18 14:21:26,28,47000,1367910,2.38
"1771",2018-12-18 14:21:38,28,1000,1368910,0.05
"1761",2018-12-18 14:21:44,28,8500,1377410,0.43
"1751",2018-12-18 14:21:47,28,10520,1387930,0.53
"1741",2018-12-18 14:22:00,28,880,1388810,0.04
"1731",2018-12-18 14:22:08,27.95,46400,1435210,2.35
"1721",2018-12-18 14:22:10,27.95,790,1436000,0.04
"1711",2018-12-18 14:22:30,27.9,65000,1501000,3.29
"1701",2018-12-18 14:22:38,27.8,2000,1503000,0.1
"1691",2018-12-18 14:24:04,27.85,9300,1512300,0.47
"1681",2018-12-18 14:24:29,27.85,300,1512600,0.02
"1671",2018-12-18 14:24:42,27.85,100,1512700,0.01
"1661",2018-12-18 14:24:46,27.85,30,1512730,0
"1651",2018-12-18 14:24:57,27.85,500,1513230,0.03
"1641",2018-12-18 14:25:02,27.85,4100,1517330,0.21
"1631",2018-12-18 14:25:34,27.95,10,1517340,0
"1621",2018-12-18 14:25:44,27.85,200,1517540,0.01
"1611",2018-12-18 14:25:56,27.95,50,1517590,0
"1601",2018-12-18 14:26:00,27.85,150,1517740,0.01
"1591",2018-12-18 14:26:37,27.85,500,1518240,0.03
"1581",2018-12-18 14:27:21,27.85,100,1518340,0.01
"1571",2018-12-18 14:27:29,27.9,20,1518360,0
"1561",2018-12-18 14:27:40,27.9,180,1518540,0.01
"1551",2018-12-18 14:27:51,27.9,630,1519170,0.03
"1541",2018-12-18 14:28:02,27.95,100,1519270,0.01
"1531",2018-12-18 14:28:32,27.95,50,1519320,0
"1521",2018-12-18 14:28:38,27.95,3000,1522320,0.15
"1511",2018-12-18 14:29:02,27.95,2000,1524320,0.1
"1501",2018-12-18 14:29:14,27.95,500,1524820,0.03
"1491",2018-12-18 14:29:33,27.95,50,1524870,0
"1481",2018-12-18 14:29:36,27.9,550,1525420,0.03
"1471",2018-12-18 14:29:47,27.9,2000,1527420,0.1
"1461",2018-12-18 14:29:58,27.9,7240,1534660,0.37
"1451",2018-12-18 14:30:04,27.9,100,1534760,0.01
"1441",2018-12-18 14:30:09,27.9,10,1534770,0
"1431",2018-12-18 14:30:15,27.9,80,1534850,0
"1421",2018-12-18 14:30:34,27.85,280,1535130,0.01
"1411",2018-12-18 14:30:36,27.85,50,1535180,0
"1401",2018-12-18 14:30:40,27.85,1000,1536180,0.05
"1391",2018-12-18 14:30:46,27.85,260,1536440,0.01
"1381",2018-12-18 14:30:54,27.9,10000,1546440,0.51
"1371",2018-12-18 14:30:58,27.9,1570,1548010,0.08
"1361",2018-12-18 14:31:14,27.9,1500,1549510,0.08
"1351",2018-12-18 14:31:25,27.95,2000,1551510,0.1
"1341",2018-12-18 14:31:37,27.9,500,1552010,0.03
"1331",2018-12-18 14:31:51,27.95,200,1552210,0.01
"1321",2018-12-18 14:32:12,27.95,80,1552290,0
"1311",2018-12-18 14:32:14,27.95,2000,1554290,0.1
"1301",2018-12-18 14:32:35,27.95,10,1554300,0
"1291",2018-12-18 14:32:43,27.95,20,1554320,0
"1281",2018-12-18 14:32:55,27.95,200,1554520,0.01
"1271",2018-12-18 14:33:07,27.95,10,1554530,0
"1261",2018-12-18 14:33:11,27.9,1530,1556060,0.08
"1251",2018-12-18 14:33:13,27.95,1000,1557060,0.05
"1241",2018-12-18 14:33:15,27.9,2000,1559060,0.1
"1231",2018-12-18 14:34:15,27.95,5000,1564060,0.25
"1221",2018-12-18 14:34:29,27.9,50,1564110,0
"1211",2018-12-18 14:34:34,27.95,5300,1569410,0.27
"1201",2018-12-18 14:34:41,27.95,10000,1579410,0.51
"1191",2018-12-18 14:34:54,28,5000,1584410,0.25
"1181",2018-12-18 14:35:23,28,1000,1585410,0.05
"1171",2018-12-18 14:35:35,28,5000,1590410,0.25
"1161",2018-12-18 14:35:36,28,10,1590420,0
"1151",2018-12-18 14:35:58,28,5000,1595420,0.25
"1141",2018-12-18 14:36:09,27.95,1500,1596920,0.08
"1131",2018-12-18 14:36:17,28,10000,1606920,0.51
"1121",2018-12-18 14:36:21,28,2000,1608920,0.1
"1111",2018-12-18 14:36:24,28,550,1609470,0.03
"1101",2018-12-18 14:36:26,28,5000,1614470,0.25
"1091",2018-12-18 14:36:46,28,1000,1615470,0.05
"1081",2018-12-18 14:37:04,28,1500,1616970,0.08
"1071",2018-12-18 14:37:12,28,1000,1617970,0.05
"1061",2018-12-18 14:37:13,28,3610,1621580,0.18
"1051",2018-12-18 14:37:27,27.95,40,1621620,0
"1041",2018-12-18 14:37:38,28,3080,1624700,0.16
"1031",2018-12-18 14:37:42,28,2000,1626700,0.1
"1021",2018-12-18 14:38:11,28,1000,1627700,0.05
"1011",2018-12-18 14:39:51,28.05,3000,1630700,0.15
"1001",2018-12-18 14:39:53,28.05,500,1631200,0.03
"991",2018-12-18 14:40:09,28.05,1220,1632420,0.06
"981",2018-12-18 14:41:06,28.05,2000,1634420,0.1
"971",2018-12-18 14:41:11,28.05,5000,1639420,0.25
"961",2018-12-18 14:41:21,28.1,50,1639470,0
"951",2018-12-18 14:42:12,28.1,3000,1642470,0.15
"941",2018-12-18 14:42:28,28.1,5000,1647470,0.25
"931",2018-12-18 14:42:37,28.1,100,1647570,0.01
"921",2018-12-18 14:42:44,28.1,600,1648170,0.03
"911",2018-12-18 14:44:14,28.1,4760,1652930,0.24
"901",2018-12-18 14:44:34,28.1,1000,1653930,0.05
"891",2018-12-18 14:45:56,28.15,2480,1656410,0.13
"881",2018-12-18 14:46:50,28.1,200,1656610,0.01
"871",2018-12-18 14:46:53,28.1,500,1657110,0.03
"861",2018-12-18 14:47:00,28.1,300,1657410,0.02
"851",2018-12-18 14:47:35,28.1,200,1657610,0.01
"841",2018-12-18 14:47:52,28.1,160,1657770,0.01
"831",2018-12-18 14:48:26,28.1,200,1657970,0.01
"821",2018-12-18 14:49:23,28.1,800,1658770,0.04
"811",2018-12-18 14:49:51,28.1,30,1658800,0
"801",2018-12-18 14:50:33,28.1,5370,1664170,0.27
"791",2018-12-18 14:50:40,28.1,630,1664800,0.03
"781",2018-12-18 14:50:42,28.1,250,1665050,0.01
"771",2018-12-18 14:52:13,28.1,10,1665060,0
"761",2018-12-18 14:53:28,28.1,5040,1670100,0.26
"751",2018-12-18 14:53:29,28.1,700,1670800,0.04
"741",2018-12-18 14:53:46,28.1,1000,1671800,0.05
"731",2018-12-18 14:54:46,28.15,100,1671900,0.01
"721",2018-12-18 14:55:55,28.15,5270,1677170,0.27
"711",2018-12-18 14:56:39,28.15,500,1677670,0.03
"701",2018-12-18 14:57:05,28.15,10,1677680,0
"691",2018-12-18 14:57:36,28.1,200,1677880,0.01
"681",2018-12-18 14:57:37,28.15,500,1678380,0.03
"671",2018-12-18 14:57:48,28.15,150,1678530,0.01
"661",2018-12-18 14:57:57,28.15,70,1678600,0
"651",2018-12-18 14:58:31,28.15,200,1678800,0.01
"641",2018-12-18 15:00:19,28.15,1700,1680500,0.09
"631",2018-12-18 15:01:11,28.15,2000,1682500,0.1
"621",2018-12-18 15:02:12,28.15,880,1683380,0.04
"611",2018-12-18 15:02:25,28.15,4480,1687860,0.23
"601",2018-12-18 15:03:21,28.15,5000,1692860,0.25
"591",2018-12-18 15:04:08,28.15,520,1693380,0.03
"581",2018-12-18 15:04:41,28.15,4480,1697860,0.23
"571",2018-12-18 15:05:49,28.2,10000,1707860,0.51
"561",2018-12-18 15:06:29,28.25,6640,1714500,0.34
"551",2018-12-18 15:07:05,28.2,10000,1724500,0.51
"547",2018-12-18 15:07:45,28.2,15000,1739500,0.76
"5310",2018-12-18 15:08:07,28.25,200,1739700,0.01
"5210",2018-12-18 15:08:21,28.25,700,1740400,0.04
"5110",2018-12-18 15:08:30,28.25,500,1740900,0.03
"5010",2018-12-18 15:08:34,28.25,100,1741000,0.01
"4910",2018-12-18 15:09:18,28.25,560,1741560,0.03
"4810",2018-12-18 15:10:26,28.25,4000,1745560,0.2
"4710",2018-12-18 15:10:57,28.25,250,1745810,0.01
"4610",2018-12-18 15:11:30,28.2,200,1746010,0.01
"4510",2018-12-18 15:11:39,28.25,1000,1747010,0.05
"4410",2018-12-18 15:12:14,28.25,30,1747040,0
"4310",2018-12-18 15:12:32,28.25,1000,1748040,0.05
"4210",2018-12-18 15:13:38,28.2,2000,1750040,0.1
"4110",2018-12-18 15:13:49,28.2,3000,1753040,0.15
"4010",2018-12-18 15:14:36,28.2,3420,1756460,0.17
"3910",2018-12-18 15:15:04,28.2,1000,1757460,0.05
"3810",2018-12-18 15:15:13,28.2,1030,1758490,0.05
"3710",2018-12-18 15:16:31,28.2,160,1758650,0.01
"3610",2018-12-18 15:16:36,28.15,2000,1760650,0.1
"3510",2018-12-18 15:16:57,28.15,200,1760850,0.01
"3410",2018-12-18 15:17:02,28.15,4000,1764850,0.2
"3310",2018-12-18 15:17:16,28.15,2000,1766850,0.1
"3210",2018-12-18 15:17:34,28.15,3000,1769850,0.15
"3110",2018-12-18 15:17:43,28.15,300,1770150,0.02
"3010",2018-12-18 15:17:49,28.15,200,1770350,0.01
"2910",2018-12-18 15:19:16,28.2,1120,1771470,0.06
"2810",2018-12-18 15:19:32,28.2,10000,1781470,0.51
"2710",2018-12-18 15:20:58,28.2,100,1781570,0.01
"2610",2018-12-18 15:21:09,28.2,170,1781740,0.01
"2510",2018-12-18 15:22:17,28.2,5000,1786740,0.25
"2410",2018-12-18 15:22:41,28.2,920,1787660,0.05
"2310",2018-12-18 15:23:27,28.2,70,1787730,0
"2210",2018-12-18 15:24:41,28.2,20,1787750,0
"2110",2018-12-18 15:24:56,28.2,1000,1788750,0.05
"2010",2018-12-18 15:25:09,28.15,1100,1789850,0.06
"1910",2018-12-18 15:25:47,28.15,300,1790150,0.02
"1810",2018-12-18 15:26:28,28.15,8970,1799120,0.45
"1710",2018-12-18 15:26:40,28.15,1000,1800120,0.05
"1610",2018-12-18 15:26:47,28.1,5000,1805120,0.25
"1510",2018-12-18 15:27:19,28.15,1700,1806820,0.09
"1410",2018-12-18 15:27:27,28.15,1300,1808120,0.07
"1310",2018-12-18 15:27:32,28.15,440,1808560,0.02
"1210",2018-12-18 15:27:53,28.15,1000,1809560,0.05
"1110",2018-12-18 15:27:59,28.1,5000,1814560,0.25
"1010",2018-12-18 15:28:14,28.15,1000,1815560,0.05
"910",2018-12-18 15:28:24,28.1,6000,1821560,0.3
"810",2018-12-18 15:28:25,28.15,100,1821660,0.01
"710",2018-12-18 15:29:08,28.1,5900,1827560,0.3
"610",2018-12-18 15:29:24,28.15,2000,1829560,0.1
"548",2018-12-18 15:29:25,28.15,200,1829760,0.01
"4100",2018-12-18 15:29:28,28.15,3960,1833720,0.2
"3100",2018-12-18 15:29:44,28.2,10,1833730,0
"2100",2018-12-18 15:29:52,28.15,1370,1835100,0.07
"1100",2018-12-18 15:47:14,28.2,140290,1975390,7.1
"3821",2018-12-19 10:15:37,28.45,10200,10200,0.76
"3811",2018-12-19 10:15:42,28.2,10000,20200,0.74
"3801",2018-12-19 10:18:18,28.2,6300,26500,0.47
"3791",2018-12-19 10:19:37,28.3,1500,28000,0.11
"3781",2018-12-19 10:20:28,28.3,340,28340,0.03
"3772",2018-12-19 10:20:40,28.4,20,28360,0
"3762",2018-12-19 10:21:06,28.4,1000,29360,0.07
"3752",2018-12-19 10:21:07,28.3,1170,30530,0.09
"3742",2018-12-19 10:21:10,28.3,30,30560,0
"3732",2018-12-19 10:21:42,28.3,470,31030,0.03
"3722",2018-12-19 10:22:02,28.2,10,31040,0
"3712",2018-12-19 10:25:29,28.3,50,31090,0
"3702",2018-12-19 10:26:12,28.25,5300,36390,0.39
"3692",2018-12-19 10:26:16,28.3,1000,37390,0.07
"3682",2018-12-19 10:26:40,28.3,2000,39390,0.15
"3672",2018-12-19 10:26:49,28.25,350,39740,0.03
"3662",2018-12-19 10:27:22,28.25,1000,40740,0.07
"3652",2018-12-19 10:29:22,28.25,3000,43740,0.22
"3642",2018-12-19 10:29:26,28.25,3090,46830,0.23
"3632",2018-12-19 10:30:19,28.2,7500,54330,0.56
"3622",2018-12-19 10:31:02,28.2,3000,57330,0.22
"3612",2018-12-19 10:31:19,28.25,100,57430,0.01
"3602",2018-12-19 10:31:22,28.2,4000,61430,0.3
"3592",2018-12-19 10:31:32,28.2,300,61730,0.02
"3582",2018-12-19 10:31:48,28.2,70,61800,0.01
"3572",2018-12-19 10:32:37,28.2,290,62090,0.02
"3562",2018-12-19 10:32:40,28.2,40,62130,0
"3552",2018-12-19 10:32:50,28.2,50,62180,0
"3542",2018-12-19 10:33:26,28.2,300,62480,0.02
"3532",2018-12-19 10:33:47,28.25,50,62530,0
"3522",2018-12-19 10:33:53,28.2,120,62650,0.01
"3512",2018-12-19 10:34:07,28.2,60,62710,0
"3502",2018-12-19 10:34:29,28.25,2500,65210,0.19
"3492",2018-12-19 10:34:31,28.2,1000,66210,0.07
"3482",2018-12-19 10:34:45,28.2,150,66360,0.01
"3472",2018-12-19 10:37:37,28.2,50,66410,0
"3462",2018-12-19 10:39:53,28.2,100,66510,0.01
"3452",2018-12-19 10:40:04,28.25,410,66920,0.03
"3442",2018-12-19 10:40:07,28.2,50,66970,0
"3432",2018-12-19 10:40:30,28.25,40,67010,0
"3422",2018-12-19 10:41:59,28.25,200,67210,0.01
"3412",2018-12-19 10:44:35,28.25,1000,68210,0.07
"3402",2018-12-19 10:51:21,28.25,3000,71210,0.22
"3392",2018-12-19 10:51:51,28.3,230,71440,0.02
"3382",2018-12-19 10:53:19,28.25,16110,87550,1.19
"3372",2018-12-19 10:53:22,28.25,50,87600,0
"3362",2018-12-19 10:54:47,28.25,5000,92600,0.37
"3352",2018-12-19 10:55:28,28.25,870,93470,0.06
"3342",2018-12-19 10:55:50,28.25,130,93600,0.01
"3332",2018-12-19 10:55:53,28.25,5000,98600,0.37
"3322",2018-12-19 10:55:55,28.25,870,99470,0.06
"3312",2018-12-19 10:56:58,28.25,10,99480,0
"3302",2018-12-19 10:59:47,28.25,850,100330,0.06
"3292",2018-12-19 11:02:08,28.2,40000,140330,2.96
"3282",2018-12-19 11:02:19,28.2,350,140680,0.03
"3272",2018-12-19 11:02:47,28.2,100,140780,0.01
"3262",2018-12-19 11:03:19,28.2,3550,144330,0.26
"3252",2018-12-19 11:03:56,28.2,1000,145330,0.07
"3242",2018-12-19 11:04:06,28.2,450,145780,0.03
"3232",2018-12-19 11:06:29,28.2,2050,147830,0.15
"3222",2018-12-19 11:06:53,28.2,100,147930,0.01
"3212",2018-12-19 11:07:13,28.2,890,148820,0.07
"3202",2018-12-19 11:08:38,28.15,1000,149820,0.07
"3192",2018-12-19 11:10:59,28.2,2000,151820,0.15
"3182",2018-12-19 11:12:28,28.2,3000,154820,0.22
"3172",2018-12-19 11:13:16,28.2,200,155020,0.01
"3162",2018-12-19 11:15:14,28.15,8720,163740,0.65
"3152",2018-12-19 11:15:20,28.15,770,164510,0.06
"3142",2018-12-19 11:15:29,28.15,510,165020,0.04
"3132",2018-12-19 11:16:05,28.15,2000,167020,0.15
"3122",2018-12-19 11:16:35,28.15,490,167510,0.04
"3112",2018-12-19 11:16:44,28.15,10,167520,0
"3102",2018-12-19 11:17:12,28.05,4000,171520,0.3
"3092",2018-12-19 11:17:28,28.05,700,172220,0.05
"3082",2018-12-19 11:17:39,28.15,50,172270,0
"3072",2018-12-19 11:17:45,28.05,100,172370,0.01
"3062",2018-12-19 11:18:31,28.15,450,172820,0.03
"3052",2018-12-19 11:18:36,28.15,50,172870,0
"3042",2018-12-19 11:18:37,28.05,290,173160,0.02
"3032",2018-12-19 11:21:35,28.1,1090,174250,0.08
"3022",2018-12-19 11:24:18,28.1,5000,179250,0.37
"3012",2018-12-19 11:25:36,28.1,1500,180750,0.11
"3002",2018-12-19 11:26:06,28.1,18000,198750,1.33
"2992",2018-12-19 11:28:04,28.1,770,199520,0.06
"2982",2018-12-19 11:30:05,28.1,50,199570,0
"2972",2018-12-19 11:31:02,28.1,30,199600,0
"2962",2018-12-19 11:31:45,28.1,1000,200600,0.07
"2952",2018-12-19 11:32:13,28.1,3000,203600,0.22
"2942",2018-12-19 11:32:54,28.1,790,204390,0.06
"2932",2018-12-19 11:33:32,28.1,1500,205890,0.11
"2922",2018-12-19 11:33:52,28.1,610,206500,0.05
"2912",2018-12-19 11:34:15,28.1,10,206510,0
"2902",2018-12-19 11:34:37,28.1,50,206560,0
"2892",2018-12-19 11:36:16,28.1,330,206890,0.02
"2882",2018-12-19 11:38:05,28.15,3000,209890,0.22
"2872",2018-12-19 11:38:12,28.1,5000,214890,0.37
"2862",2018-12-19 11:38:13,28.1,5410,220300,0.4
"2852",2018-12-19 11:40:11,28.1,500,220800,0.04
"2842",2018-12-19 11:41:32,28.1,290,221090,0.02
"2832",2018-12-19 11:43:18,28.1,50,221140,0
"2822",2018-12-19 11:45:06,28.15,5300,226440,0.39
"2812",2018-12-19 11:45:55,28.15,2000,228440,0.15
"2802",2018-12-19 11:46:02,28.15,3000,231440,0.22
"2792",2018-12-19 11:46:05,28.15,30,231470,0
"2782",2018-12-19 11:46:08,28.15,1000,232470,0.07
"2772",2018-12-19 11:46:20,28.15,4000,236470,0.3
"2762",2018-12-19 11:46:23,28.1,80,236550,0.01
"2752",2018-12-19 11:46:28,28.15,1000,237550,0.07
"2742",2018-12-19 11:46:48,28.15,500,238050,0.04
"2732",2018-12-19 11:46:56,28.15,200,238250,0.01
"2722",2018-12-19 11:46:59,28.15,1000,239250,0.07
"2712",2018-12-19 11:47:10,28.15,50,239300,0
"2702",2018-12-19 11:47:14,28.15,200,239500,0.01
"2692",2018-12-19 11:50:03,28.15,50,239550,0
"2682",2018-12-19 11:50:36,28.15,500,240050,0.04
"2672",2018-12-19 11:53:28,28.1,1000,241050,0.07
"2662",2018-12-19 11:53:38,28.15,2000,243050,0.15
"2652",2018-12-19 11:54:12,28.1,1500,244550,0.11
"2642",2018-12-19 11:54:50,28.1,5000,249550,0.37
"2632",2018-12-19 11:55:17,28.1,12000,261550,0.89
"2622",2018-12-19 11:58:25,28.1,5000,266550,0.37
"2612",2018-12-19 12:00:06,28.15,1500,268050,0.11
"2602",2018-12-19 12:00:23,28.1,1000,269050,0.07
"2592",2018-12-19 12:01:08,28.1,130,269180,0.01
"2582",2018-12-19 12:02:26,28.15,300,269480,0.02
"2572",2018-12-19 12:05:50,28.15,800,270280,0.06
"2562",2018-12-19 12:06:35,28.2,21360,291640,1.58
"2552",2018-12-19 12:07:08,28.2,28640,320280,2.12
"2542",2018-12-19 12:07:16,28.2,560,320840,0.04
"2532",2018-12-19 12:07:25,28.2,800,321640,0.06
"2522",2018-12-19 12:07:36,28.2,11200,332840,0.83
"2512",2018-12-19 12:08:47,28.15,1000,333840,0.07
"2502",2018-12-19 12:08:58,28.15,2000,335840,0.15
"2492",2018-12-19 12:09:06,28.15,1000,336840,0.07
"2482",2018-12-19 12:10:11,28.1,11000,347840,0.82
"2472",2018-12-19 12:10:43,28.1,2000,349840,0.15
"2462",2018-12-19 12:11:00,28.1,1000,350840,0.07
"2452",2018-12-19 12:11:30,28.1,51000,401840,3.78
"2442",2018-12-19 12:12:21,28.15,5000,406840,0.37
"2432",2018-12-19 12:13:01,28.1,15000,421840,1.11
"2422",2018-12-19 12:13:21,28.1,1070,422910,0.08
"2412",2018-12-19 12:13:29,28.1,3000,425910,0.22
"2402",2018-12-19 12:13:58,28.1,100,426010,0.01
"2392",2018-12-19 12:16:23,28.05,24960,450970,1.85
"2382",2018-12-19 12:16:32,28.05,40,451010,0
"2372",2018-12-19 12:16:38,28,22000,473010,1.63
"2362",2018-12-19 12:17:07,28,10000,483010,0.74
"2352",2018-12-19 12:17:23,28,1000,484010,0.07
"2342",2018-12-19 12:17:31,28,5000,489010,0.37
"2332",2018-12-19 12:17:39,28,1000,490010,0.07
"2322",2018-12-19 12:17:47,28.05,20,490030,0
"2312",2018-12-19 12:17:54,28.05,980,491010,0.07
"2302",2018-12-19 12:18:09,28.05,15020,506030,1.11
"2292",2018-12-19 12:18:14,28.05,500,506530,0.04
"2282",2018-12-19 12:19:47,28.05,10000,516530,0.74
"2272",2018-12-19 12:20:22,28.05,9480,526010,0.7
"2262",2018-12-19 12:20:40,28.1,4000,530010,0.3
"2252",2018-12-19 12:21:00,28.05,15520,545530,1.15
"2242",2018-12-19 12:21:11,28.05,2280,547810,0.17
"2232",2018-12-19 12:21:26,28.05,10000,557810,0.74
"2222",2018-12-19 12:21:30,28.05,2320,560130,0.17
"2212",2018-12-19 12:21:57,28.05,3500,563630,0.26
"2202",2018-12-19 12:22:06,28.05,110,563740,0.01
"2192",2018-12-19 12:22:31,28.05,2470,566210,0.18
"2182",2018-12-19 12:22:47,28.05,10600,576810,0.79
"2172",2018-12-19 12:22:55,28.05,8900,585710,0.66
"2162",2018-12-19 12:23:59,28.05,6000,591710,0.44
"2152",2018-12-19 12:24:04,28.05,790,592500,0.06
"2142",2018-12-19 12:24:06,28,31920,624420,2.37
"2132",2018-12-19 12:24:18,28,3580,628000,0.27
"2122",2018-12-19 12:25:27,28.05,3000,631000,0.22
"2112",2018-12-19 12:26:10,28.05,2370,633370,0.18
"2102",2018-12-19 12:26:38,28.05,940,634310,0.07
"2092",2018-12-19 14:01:12,28.05,12120,646430,0.9
"2082",2018-12-19 14:02:11,28.1,10,646440,0
"2072",2018-12-19 14:02:56,28.1,2370,648810,0.18
"2062",2018-12-19 14:02:58,28.1,300,649110,0.02
"2052",2018-12-19 14:04:19,28.1,3000,652110,0.22
"2042",2018-12-19 14:05:44,28.1,1500,653610,0.11
"2032",2018-12-19 14:06:28,28.1,4200,657810,0.31
"2022",2018-12-19 14:06:45,28.1,10,657820,0
"2012",2018-12-19 14:08:20,28.1,1720,659540,0.13
"2002",2018-12-19 14:09:01,28.15,1500,661040,0.11
"1992",2018-12-19 14:10:23,28.1,90,661130,0.01
"1982",2018-12-19 14:10:26,28.1,210,661340,0.02
"1972",2018-12-19 14:11:19,28.1,2590,663930,0.19
"1962",2018-12-19 14:12:20,28.15,1500,665430,0.11
"1952",2018-12-19 14:12:36,28.1,1000,666430,0.07
"1942",2018-12-19 14:13:30,28.1,500,666930,0.04
"1932",2018-12-19 14:13:34,28.1,190,667120,0.01
"1922",2018-12-19 14:13:58,28.05,6370,673490,0.47
"1912",2018-12-19 14:14:20,28.05,500,673990,0.04
"1902",2018-12-19 14:14:25,28.05,5000,678990,0.37
"1892",2018-12-19 14:14:50,28.05,1080,680070,0.08
"1882",2018-12-19 14:14:54,28,45000,725070,3.33
"1872",2018-12-19 14:15:04,28,2000,727070,0.15
"1862",2018-12-19 14:15:05,28.05,4450,731520,0.33
"1852",2018-12-19 14:15:09,28.05,600,732120,0.04
"1842",2018-12-19 14:15:18,28.05,10740,742860,0.8
"1832",2018-12-19 14:15:37,28.05,1510,744370,0.11
"1822",2018-12-19 14:15:53,28,210,744580,0.02
"1812",2018-12-19 14:16:04,28,200,744780,0.01
"1802",2018-12-19 14:16:25,28,10000,754780,0.74
"1792",2018-12-19 14:16:27,28.05,4200,758980,0.31
"1782",2018-12-19 14:16:32,28,6350,765330,0.47
"1772",2018-12-19 14:16:41,27.95,500,765830,0.04
"1762",2018-12-19 14:16:46,28,9150,774980,0.68
"1752",2018-12-19 14:16:54,28,500,775480,0.04
"1742",2018-12-19 14:17:16,28,450,775930,0.03
"1732",2018-12-19 14:18:17,28,4000,779930,0.3
"1722",2018-12-19 14:18:18,27.95,8000,787930,0.59
"1712",2018-12-19 14:18:25,28,200,788130,0.01
"1702",2018-12-19 14:18:45,27.95,1000,789130,0.07
"1692",2018-12-19 14:18:52,27.95,6780,795910,0.5
"1682",2018-12-19 14:18:55,27.95,1500,797410,0.11
"1672",2018-12-19 14:19:02,28.05,5000,802410,0.37
"1662",2018-12-19 14:19:39,27.95,700,803110,0.05
"1652",2018-12-19 14:20:10,27.95,900,804010,0.07
"1642",2018-12-19 14:20:14,27.95,490,804500,0.04
"1632",2018-12-19 14:20:37,27.9,10000,814500,0.74
"1622",2018-12-19 14:21:18,27.95,10,814510,0
"1612",2018-12-19 14:22:14,27.95,1000,815510,0.07
"1602",2018-12-19 14:23:12,28,30,815540,0
"1592",2018-12-19 14:23:46,28,710,816250,0.05
"1582",2018-12-19 14:24:03,28,200,816450,0.01
"1572",2018-12-19 14:25:33,28,1710,818160,0.13
"1562",2018-12-19 14:25:37,28,350,818510,0.03
"1552",2018-12-19 14:26:55,27.95,1000,819510,0.07
"1542",2018-12-19 14:28:50,28,1500,821010,0.11
"1532",2018-12-19 14:29:08,28,4000,825010,0.3
"1522",2018-12-19 14:29:42,27.95,10,825020,0
"1512",2018-12-19 14:30:32,27.95,1420,826440,0.11
"1502",2018-12-19 14:30:33,27.95,200,826640,0.01
"1492",2018-12-19 14:31:05,28,4200,830840,0.31
"1482",2018-12-19 14:31:47,27.95,5500,836340,0.41
"1472",2018-12-19 14:31:50,27.95,300,836640,0.02
"1462",2018-12-19 14:32:10,28,1510,838150,0.11
"1452",2018-12-19 14:33:16,27.95,100,838250,0.01
"1442",2018-12-19 14:33:34,27.95,2000,840250,0.15
"1432",2018-12-19 14:33:45,27.95,5030,845280,0.37
"1422",2018-12-19 14:33:52,27.9,8280,853560,0.61
"1412",2018-12-19 14:34:14,27.9,10,853570,0
"1402",2018-12-19 14:35:02,27.95,2500,856070,0.19
"1392",2018-12-19 14:35:27,28,1510,857580,0.11
"1382",2018-12-19 14:35:32,27.95,2000,859580,0.15
"1372",2018-12-19 14:36:41,28,2100,861680,0.16
"1362",2018-12-19 14:36:49,27.95,10,861690,0
"1352",2018-12-19 14:36:58,27.95,500,862190,0.04
"1342",2018-12-19 14:37:13,28,2500,864690,0.19
"1332",2018-12-19 14:38:36,27.95,1000,865690,0.07
"1322",2018-12-19 14:38:45,28,1510,867200,0.11
"1312",2018-12-19 14:38:53,28,10000,877200,0.74
"1302",2018-12-19 14:39:13,28,3500,880700,0.26
"1292",2018-12-19 14:39:14,27.95,1000,881700,0.07
"1282",2018-12-19 14:40:55,27.95,3000,884700,0.22
"1272",2018-12-19 14:41:16,27.95,1000,885700,0.07
"1262",2018-12-19 14:41:18,27.95,420,886120,0.03
"1252",2018-12-19 14:41:24,28,30,886150,0
"1242",2018-12-19 14:41:43,28,2370,888520,0.18
"1232",2018-12-19 14:42:04,28,1510,890030,0.11
"1222",2018-12-19 14:42:25,27.95,500,890530,0.04
"1212",2018-12-19 14:42:26,28,5000,895530,0.37
"1202",2018-12-19 14:42:42,28,20,895550,0
"1192",2018-12-19 14:42:45,27.95,80,895630,0.01
"1182",2018-12-19 14:43:04,27.95,250,895880,0.02
"1172",2018-12-19 14:43:07,28,300,896180,0.02
"1162",2018-12-19 14:43:41,28,250,896430,0.02
"1152",2018-12-19 14:43:53,28,1000,897430,0.07
"1142",2018-12-19 14:44:22,28,400,897830,0.03
"1132",2018-12-19 14:44:41,28,2920,900750,0.22
"1122",2018-12-19 14:44:49,28,2370,903120,0.18
"1112",2018-12-19 14:45:23,28,1510,904630,0.11
"1102",2018-12-19 14:45:31,28,500,905130,0.04
"1092",2018-12-19 14:45:45,28,10000,915130,0.74
"1082",2018-12-19 14:45:55,28,5000,920130,0.37
"1072",2018-12-19 14:46:00,28,2370,922500,0.18
"1062",2018-12-19 14:46:09,28,4200,926700,0.31
"1052",2018-12-19 14:46:11,28,5000,931700,0.37
"1042",2018-12-19 14:46:12,28,8890,940590,0.66
"1032",2018-12-19 14:46:23,28.05,6000,946590,0.44
"1022",2018-12-19 14:47:00,28.05,1000,947590,0.07
"1012",2018-12-19 14:47:05,28.05,50,947640,0
"1002",2018-12-19 14:47:26,28.05,1700,949340,0.13
"992",2018-12-19 14:47:34,28.05,400,949740,0.03
"982",2018-12-19 14:47:54,28,3000,952740,0.22
"972",2018-12-19 14:48:40,28.05,1510,954250,0.11
"962",2018-12-19 14:49:21,28.05,2370,956620,0.18
"952",2018-12-19 14:50:09,28.05,4000,960620,0.3
"942",2018-12-19 14:50:33,28.05,3000,963620,0.22
"932",2018-12-19 14:50:49,28.05,14540,978160,1.08
"922",2018-12-19 14:50:50,28.05,2000,980160,0.15
"912",2018-12-19 14:51:36,28.1,10000,990160,0.74
"902",2018-12-19 14:51:55,28.1,9110,999270,0.68
"892",2018-12-19 14:51:57,28.1,890,1000160,0.07
"882",2018-12-19 14:52:00,28.1,1510,1001670,0.11
"872",2018-12-19 14:52:07,28.1,530,1002200,0.04
"862",2018-12-19 14:52:15,28.1,10000,1012200,0.74
"852",2018-12-19 14:52:29,28.1,3070,1015270,0.23
"842",2018-12-19 14:52:45,28.15,14000,1029270,1.04
"832",2018-12-19 14:52:54,28.15,100,1029370,0.01
"822",2018-12-19 14:52:59,28.15,1000,1030370,0.07
"812",2018-12-19 14:53:35,28.15,1700,1032070,0.13
"802",2018-12-19 14:53:41,28.2,60,1032130,0
"792",2018-12-19 14:53:58,28.2,10,1032140,0
"782",2018-12-19 14:53:59,28.2,5000,1037140,0.37
"772",2018-12-19 14:54:20,28.15,100,1037240,0.01
"762",2018-12-19 14:55:07,28.2,50,1037290,0
"752",2018-12-19 14:55:17,28.2,1510,1038800,0.11
"742",2018-12-19 14:55:27,28.2,20,1038820,0
"732",2018-12-19 14:55:48,28.2,2000,1040820,0.15
"722",2018-12-19 14:55:59,28.2,500,1041320,0.04
"712",2018-12-19 14:56:02,28.2,2000,1043320,0.15
"702",2018-12-19 14:56:05,28.15,300,1043620,0.02
"692",2018-12-19 14:56:49,28.15,11890,1055510,0.88
"682",2018-12-19 14:57:03,28.15,100,1055610,0.01
"672",2018-12-19 14:58:02,28.2,1000,1056610,0.07
"662",2018-12-19 14:58:37,28.2,1510,1058120,0.11
"652",2018-12-19 14:58:54,28.2,20,1058140,0
"642",2018-12-19 14:59:05,28.2,10,1058150,0
"632",2018-12-19 14:59:24,28.2,39930,1098080,2.96
"622",2018-12-19 14:59:33,28.2,2880,1100960,0.21
"612",2018-12-19 15:00:13,28.25,10,1100970,0
"602",2018-12-19 15:01:08,28.25,4210,1105180,0.31
"592",2018-12-19 15:01:38,28.25,4000,1109180,0.3
"582",2018-12-19 15:01:50,28.25,910,1110090,0.07
"572",2018-12-19 15:01:55,28.25,1510,1111600,0.11
"562",2018-12-19 15:02:09,28.25,4000,1115600,0.3
"552",2018-12-19 15:03:39,28.25,8000,1123600,0.59
"549",2018-12-19 15:03:48,28.25,6930,1130530,0.51
"5311",2018-12-19 15:04:13,28.25,50,1130580,0
"5211",2018-12-19 15:04:24,28.3,30,1130610,0
"5111",2018-12-19 15:04:42,28.3,40,1130650,0
"5011",2018-12-19 15:04:48,28.25,6020,1136670,0.45
"4911",2018-12-19 15:04:59,28.25,20,1136690,0
"4811",2018-12-19 15:05:02,28.25,3000,1139690,0.22
"4711",2018-12-19 15:05:15,28.25,1510,1141200,0.11
"4611",2018-12-19 15:06:00,28.2,60,1141260,0
"4511",2018-12-19 15:06:19,28.25,500,1141760,0.04
"4411",2018-12-19 15:07:34,28.2,10,1141770,0
"4311",2018-12-19 15:08:19,28.2,1000,1142770,0.07
"4211",2018-12-19 15:08:31,28.25,1510,1144280,0.11
"4111",2018-12-19 15:09:17,28.25,10,1144290,0
"4011",2018-12-19 15:10:09,28.2,9740,1154030,0.72
"3911",2018-12-19 15:10:51,28.2,5000,1159030,0.37
"3812",2018-12-19 15:10:57,28.2,1000,1160030,0.07
"3713",2018-12-19 15:11:54,28.2,1510,1161540,0.11
"3613",2018-12-19 15:12:52,28.2,1430,1162970,0.11
"3513",2018-12-19 15:13:33,28.15,10,1162980,0
"3413",2018-12-19 15:13:43,28.15,4450,1167430,0.33
"3313",2018-12-19 15:13:53,28.15,2000,1169430,0.15
"3213",2018-12-19 15:14:09,28.1,100,1169530,0.01
"3113",2018-12-19 15:15:07,28.15,1510,1171040,0.11
"3013",2018-12-19 15:16:05,28.2,4200,1175240,0.31
"2913",2018-12-19 15:16:13,28.2,2000,1177240,0.15
"2813",2018-12-19 15:16:24,28.2,6300,1183540,0.47
"2713",2018-12-19 15:16:57,28.2,530,1184070,0.04
"2613",2018-12-19 15:17:05,28.2,560,1184630,0.04
"2513",2018-12-19 15:17:29,28.2,940,1185570,0.07
"2413",2018-12-19 15:17:53,28.25,10000,1195570,0.74
"2313",2018-12-19 15:18:26,28.25,1510,1197080,0.11
"2213",2018-12-19 15:19:12,28.25,1360,1198440,0.1
"2113",2018-12-19 15:19:43,28.2,300,1198740,0.02
"2013",2018-12-19 15:20:35,28.2,10,1198750,0
"1913",2018-12-19 15:21:40,28.2,300,1199050,0.02
"1813",2018-12-19 15:21:44,28.25,1510,1200560,0.11
"1713",2018-12-19 15:21:53,28.2,4790,1205350,0.35
"1613",2018-12-19 15:22:04,28.2,2000,1207350,0.15
"1513",2018-12-19 15:22:13,28.2,2500,1209850,0.19
"1413",2018-12-19 15:22:16,28.2,200,1210050,0.01
"1313",2018-12-19 15:22:45,28.2,20,1210070,0
"1213",2018-12-19 15:25:03,28.2,1310,1211380,0.1
"1113",2018-12-19 15:25:27,28.2,200,1211580,0.01
"1013",2018-12-19 15:25:34,28.2,1500,1213080,0.11
"913",2018-12-19 15:26:20,28.2,5000,1218080,0.37
"813",2018-12-19 15:26:39,28.25,4200,1222280,0.31
"713",2018-12-19 15:27:07,28.25,2000,1224280,0.15
"613",2018-12-19 15:28:33,28.2,20,1224300,0
"550",2018-12-19 15:28:45,28.2,1000,1225300,0.07
"4101",2018-12-19 15:29:37,28.15,640,1225940,0.05
"3103",2018-12-19 15:29:54,28.15,1480,1227420,0.11
"2103",2018-12-19 15:30:02,28.15,5000,1232420,0.37
"1103",2018-12-19 15:47:09,28.1,117010,1349430,8.67
"3493",2018-12-20 10:15:41,28.05,7060,7060,0.76
"3483",2018-12-20 10:16:18,28.1,500,7560,0.05
"3473",2018-12-20 10:17:01,28.05,160,7720,0.02
"3463",2018-12-20 10:17:09,28.05,2070,9790,0.22
"3453",2018-12-20 10:17:35,28.05,800,10590,0.09
"3443",2018-12-20 10:18:00,28.05,300,10890,0.03
"3433",2018-12-20 10:18:11,28.05,12000,22890,1.3
"3423",2018-12-20 10:18:16,28.05,200,23090,0.02
"3414",2018-12-20 10:19:10,28.05,4400,27490,0.48
"3403",2018-12-20 10:19:12,28.05,2000,29490,0.22
"3393",2018-12-20 10:19:19,28,400,29890,0.04
"3383",2018-12-20 10:19:28,28.05,100,29990,0.01
"3373",2018-12-20 10:19:31,28.05,240,30230,0.03
"3363",2018-12-20 10:19:39,28.05,4890,35120,0.53
"3353",2018-12-20 10:19:50,28.1,800,35920,0.09
"3343",2018-12-20 10:20:06,28.1,300,36220,0.03
"3333",2018-12-20 10:20:27,28.05,500,36720,0.05
"3323",2018-12-20 10:20:40,28.1,2000,38720,0.22
"3314",2018-12-20 10:20:45,28.1,90,38810,0.01
"3303",2018-12-20 10:20:46,28.1,20,38830,0
"3293",2018-12-20 10:21:01,28.2,1000,39830,0.11
"3283",2018-12-20 10:21:08,28.1,10,39840,0
"3273",2018-12-20 10:21:10,28.1,700,40540,0.08
"3263",2018-12-20 10:21:29,28.1,100,40640,0.01
"3253",2018-12-20 10:21:37,28.1,190,40830,0.02
"3243",2018-12-20 10:21:38,28.5,5000,45830,0.54
"3233",2018-12-20 10:22:20,28.25,500,46330,0.05
"3223",2018-12-20 10:22:52,28.25,100,46430,0.01
"3214",2018-12-20 10:22:57,28.25,2000,48430,0.22
"3203",2018-12-20 10:23:50,28.25,1400,49830,0.15
"3193",2018-12-20 10:23:51,28.25,500,50330,0.05
"3183",2018-12-20 10:24:13,28.25,40,50370,0
"3173",2018-12-20 10:24:22,28.15,540,50910,0.06
"3163",2018-12-20 10:25:04,28.25,610,51520,0.07
"3153",2018-12-20 10:27:02,28.25,3000,54520,0.32
"3143",2018-12-20 10:27:51,28.2,1000,55520,0.11
"3133",2018-12-20 10:28:27,28.2,4930,60450,0.53
"3123",2018-12-20 10:29:12,28.2,200,60650,0.02
"3114",2018-12-20 10:29:24,28.2,1000,61650,0.11
"3104",2018-12-20 10:29:41,28.2,70,61720,0.01
"3093",2018-12-20 10:29:56,28.2,2000,63720,0.22
"3083",2018-12-20 10:30:00,28.2,4000,67720,0.43
"3073",2018-12-20 10:30:10,28.2,1500,69220,0.16
"3063",2018-12-20 10:30:24,28.2,10,69230,0
"3053",2018-12-20 10:30:30,28.2,90,69320,0.01
"3043",2018-12-20 10:30:55,28.15,150,69470,0.02
"3033",2018-12-20 10:31:08,28.2,500,69970,0.05
"3023",2018-12-20 10:33:16,28.2,200,70170,0.02
"3014",2018-12-20 10:33:19,28.2,3000,73170,0.32
"3003",2018-12-20 10:33:40,28.15,1000,74170,0.11
"2993",2018-12-20 10:35:28,28.15,6440,80610,0.7
"2983",2018-12-20 10:36:07,28.15,1000,81610,0.11
"2973",2018-12-20 10:36:11,28.15,2560,84170,0.28
"2963",2018-12-20 10:37:21,28.2,10,84180,0
"2953",2018-12-20 10:37:49,28.15,1440,85620,0.16
"2943",2018-12-20 10:39:11,28.15,1500,87120,0.16
"2933",2018-12-20 10:39:56,28.15,180,87300,0.02
"2923",2018-12-20 10:42:05,28.15,350,87650,0.04
"2914",2018-12-20 10:43:14,28.15,1000,88650,0.11
"2903",2018-12-20 10:44:06,28.2,10,88660,0
"2893",2018-12-20 10:44:25,28.15,1260,89920,0.14
"2883",2018-12-20 10:44:28,28.15,2370,92290,0.26
"2873",2018-12-20 10:44:33,28.15,1500,93790,0.16
"2863",2018-12-20 10:45:27,28.15,5000,98790,0.54
"2853",2018-12-20 10:46:52,28.15,900,99690,0.1
"2843",2018-12-20 10:47:17,28.15,3000,102690,0.32
"2833",2018-12-20 10:47:37,28.15,3480,106170,0.38
"2823",2018-12-20 10:47:51,28.2,2000,108170,0.22
"2814",2018-12-20 10:48:08,28.2,4000,112170,0.43
"2803",2018-12-20 10:48:55,28.2,370,112540,0.04
"2793",2018-12-20 10:48:56,28.2,6000,118540,0.65
"2783",2018-12-20 10:48:57,28.2,700,119240,0.08
"2773",2018-12-20 10:49:02,28.15,10000,129240,1.08
"2763",2018-12-20 10:49:31,28.15,100,129340,0.01
"2753",2018-12-20 10:50:47,28.15,500,129840,0.05
"2743",2018-12-20 10:54:02,28.2,630,130470,0.07
"2733",2018-12-20 10:54:24,28.2,70,130540,0.01
"2723",2018-12-20 10:55:03,28.2,120,130660,0.01
"2714",2018-12-20 10:58:05,28.2,10,130670,0
"2703",2018-12-20 10:58:13,28.2,1000,131670,0.11
"2693",2018-12-20 10:58:18,28.2,4000,135670,0.43
"2683",2018-12-20 10:58:21,28.2,1000,136670,0.11
"2673",2018-12-20 10:58:30,28.2,10000,146670,1.08
"2663",2018-12-20 10:58:31,28.2,2370,149040,0.26
"2653",2018-12-20 11:01:06,28.25,100,149140,0.01
"2643",2018-12-20 11:01:09,28.25,230,149370,0.02
"2633",2018-12-20 11:01:25,28.25,80,149450,0.01
"2623",2018-12-20 11:01:46,28.25,1000,150450,0.11
"2614",2018-12-20 11:02:03,28.25,30100,180550,3.25
"2603",2018-12-20 11:02:17,28.25,5240,185790,0.57
"2593",2018-12-20 11:02:25,28.25,3000,188790,0.32
"2583",2018-12-20 11:02:42,28.25,4000,192790,0.43
"2573",2018-12-20 11:02:48,28.25,760,193550,0.08
"2563",2018-12-20 11:03:14,28.3,10,193560,0
"2553",2018-12-20 11:03:47,28.3,20,193580,0
"2543",2018-12-20 11:03:51,28.3,1000,194580,0.11
"2533",2018-12-20 11:04:03,28.3,40,194620,0
"2523",2018-12-20 11:05:04,28.3,10,194630,0
"2514",2018-12-20 11:05:20,28.3,2000,196630,0.22
"2503",2018-12-20 11:05:32,28.3,30,196660,0
"2493",2018-12-20 11:06:02,28.3,40,196700,0
"2483",2018-12-20 11:06:31,28.3,5000,201700,0.54
"2473",2018-12-20 11:06:35,28.3,10000,211700,1.08
"2463",2018-12-20 11:06:46,28.3,1960,213660,0.21
"2453",2018-12-20 11:06:48,28.25,2370,216030,0.26
"2443",2018-12-20 11:06:52,28.3,1000,217030,0.11
"2433",2018-12-20 11:06:54,28.3,240,217270,0.03
"2423",2018-12-20 11:06:55,28.3,6360,223630,0.69
"2414",2018-12-20 11:08:01,28.35,1000,224630,0.11
"2403",2018-12-20 11:08:09,28.35,100,224730,0.01
"2393",2018-12-20 11:08:18,28.35,6900,231630,0.75
"2383",2018-12-20 11:09:03,28.35,2370,234000,0.26
"2373",2018-12-20 11:09:14,28.35,3700,237700,0.4
"2363",2018-12-20 11:09:46,28.35,330,238030,0.04
"2353",2018-12-20 11:10:46,28.3,10,238040,0
"2343",2018-12-20 11:11:31,28.3,790,238830,0.09
"2333",2018-12-20 11:12:45,28.35,3790,242620,0.41
"2323",2018-12-20 11:13:06,28.35,580,243200,0.06
"2314",2018-12-20 11:13:21,28.35,4420,247620,0.48
"2303",2018-12-20 11:14:01,28.3,790,248410,0.09
"2293",2018-12-20 11:14:20,28.35,4700,253110,0.51
"2283",2018-12-20 11:14:53,28.35,9000,262110,0.97
"2273",2018-12-20 11:14:55,28.35,4520,266630,0.49
"2263",2018-12-20 11:15:44,28.35,1480,268110,0.16
"2253",2018-12-20 11:16:12,28.3,790,268900,0.09
"2243",2018-12-20 11:16:14,28.3,20,268920,0
"2233",2018-12-20 11:17:34,28.3,30,268950,0
"2223",2018-12-20 11:18:28,28.3,1000,269950,0.11
"2214",2018-12-20 11:18:53,28.3,300,270250,0.03
"2203",2018-12-20 11:19:11,28.3,1000,271250,0.11
"2193",2018-12-20 11:21:09,28.3,1200,272450,0.13
"2183",2018-12-20 11:21:48,28.3,4320,276770,0.47
"2173",2018-12-20 11:24:53,28.3,1000,277770,0.11
"2163",2018-12-20 11:26:38,28.25,10000,287770,1.08
"2153",2018-12-20 11:28:19,28.25,1000,288770,0.11
"2143",2018-12-20 11:31:00,28.25,400,289170,0.04
"2133",2018-12-20 11:31:12,28.25,500,289670,0.05
"2123",2018-12-20 11:31:40,28.25,3500,293170,0.38
"2114",2018-12-20 11:32:19,28.25,30,293200,0
"2104",2018-12-20 11:34:00,28.2,3000,296200,0.32
"2093",2018-12-20 11:34:03,28.25,70,296270,0.01
"2083",2018-12-20 11:34:47,28.25,270,296540,0.03
"2073",2018-12-20 11:36:18,28.25,4000,300540,0.43
"2063",2018-12-20 11:36:50,28.25,990,301530,0.11
"2053",2018-12-20 11:36:59,28.25,2000,303530,0.22
"2043",2018-12-20 11:37:09,28.25,1000,304530,0.11
"2033",2018-12-20 11:38:16,28.25,10000,314530,1.08
"2023",2018-12-20 11:38:39,28.25,1310,315840,0.14
"2014",2018-12-20 11:40:25,28.25,60,315900,0.01
"2003",2018-12-20 11:41:45,28.25,270,316170,0.03
"1993",2018-12-20 11:43:23,28.25,3990,320160,0.43
"1983",2018-12-20 11:43:28,28.25,1000,321160,0.11
"1973",2018-12-20 11:45:49,28.2,1500,322660,0.16
"1963",2018-12-20 11:46:32,28.25,500,323160,0.05
"1953",2018-12-20 11:46:57,28.25,50,323210,0.01
"1943",2018-12-20 11:48:38,28.25,100,323310,0.01
"1933",2018-12-20 11:49:09,28.25,270,323580,0.03
"1923",2018-12-20 11:49:45,28.25,1920,325500,0.21
"1914",2018-12-20 11:50:12,28.2,2000,327500,0.22
"1903",2018-12-20 11:53:33,28.2,200,327700,0.02
"1893",2018-12-20 11:53:52,28.2,7410,335110,0.8
"1883",2018-12-20 11:53:55,28.2,200,335310,0.02
"1873",2018-12-20 11:55:34,28.15,300,335610,0.03
"1863",2018-12-20 11:55:56,28.2,2390,338000,0.26
"1853",2018-12-20 11:56:40,28.2,20,338020,0
"1843",2018-12-20 11:57:38,28.2,1090,339110,0.12
"1833",2018-12-20 11:59:37,28.2,4720,343830,0.51
"1823",2018-12-20 12:00:00,28.2,270,344100,0.03
"1814",2018-12-20 12:00:18,28.2,10,344110,0
"1803",2018-12-20 12:05:16,28.2,1820,345930,0.2
"1793",2018-12-20 12:05:34,28.15,1850,347780,0.2
"1783",2018-12-20 12:05:49,28.15,10,347790,0
"1773",2018-12-20 12:09:15,28.15,18000,365790,1.95
"1763",2018-12-20 12:10:29,28.15,7500,373290,0.81
"1753",2018-12-20 12:10:56,28.15,5040,378330,0.54
"1743",2018-12-20 12:13:12,28.15,210,378540,0.02
"1733",2018-12-20 12:13:25,28.15,2020,380560,0.22
"1723",2018-12-20 12:14:04,28.2,1000,381560,0.11
"1714",2018-12-20 12:15:16,28.15,200,381760,0.02
"1703",2018-12-20 12:15:48,28.15,20,381780,0
"1693",2018-12-20 12:16:47,28.15,1000,382780,0.11
"1683",2018-12-20 12:17:27,28.15,680,383460,0.07
"1673",2018-12-20 12:18:29,28.15,5000,388460,0.54
"1663",2018-12-20 12:19:23,28.15,500,388960,0.05
"1653",2018-12-20 12:26:16,28.15,3650,392610,0.39
"1643",2018-12-20 12:26:40,28.15,2350,394960,0.25
"1633",2018-12-20 12:26:41,28.15,650,395610,0.07
"1623",2018-12-20 12:29:21,28.1,3000,398610,0.32
"1614",2018-12-20 14:01:20,28.15,46800,445410,5.06
"1603",2018-12-20 14:01:30,28.05,14480,459890,1.56
"1593",2018-12-20 14:02:08,28.05,100,459990,0.01
"1583",2018-12-20 14:02:28,28.05,420,460410,0.05
"1573",2018-12-20 14:04:39,28.05,10,460420,0
"1563",2018-12-20 14:04:41,28.05,17000,477420,1.84
"1553",2018-12-20 14:04:53,28.05,5000,482420,0.54
"1543",2018-12-20 14:05:14,28.05,470,482890,0.05
"1533",2018-12-20 14:05:34,28.05,20,482910,0
"1523",2018-12-20 14:06:05,28,500,483410,0.05
"1514",2018-12-20 14:06:16,28,59760,543170,6.46
"1503",2018-12-20 14:06:52,28,240,543410,0.03
"1493",2018-12-20 14:06:55,28,760,544170,0.08
"1483",2018-12-20 14:07:12,28,2000,546170,0.22
"1473",2018-12-20 14:07:58,28,90,546260,0.01
"1463",2018-12-20 14:07:59,28,50,546310,0.01
"1453",2018-12-20 14:08:01,28,600,546910,0.06
"1443",2018-12-20 14:08:14,28,500,547410,0.05
"1433",2018-12-20 14:08:20,28,9500,556910,1.03
"1423",2018-12-20 14:08:22,28,6000,562910,0.65
"1414",2018-12-20 14:08:42,27.95,800,563710,0.09
"1403",2018-12-20 14:08:46,28,100,563810,0.01
"1393",2018-12-20 14:09:07,28,200,564010,0.02
"1383",2018-12-20 14:09:20,27.95,5000,569010,0.54
"1373",2018-12-20 14:09:34,27.95,270,569280,0.03
"1363",2018-12-20 14:10:00,28,80,569360,0.01
"1353",2018-12-20 14:10:13,28,10,569370,0
"1343",2018-12-20 14:10:22,27.95,20,569390,0
"1333",2018-12-20 14:10:31,28,12000,581390,1.3
"1323",2018-12-20 14:11:25,28,40,581430,0
"1314",2018-12-20 14:11:56,28,7070,588500,0.76
"1303",2018-12-20 14:12:48,28,500,589000,0.05
"1293",2018-12-20 14:13:37,28,150,589150,0.02
"1283",2018-12-20 14:16:20,28,11080,600230,1.2
"1273",2018-12-20 14:16:31,28,3000,603230,0.32
"1263",2018-12-20 14:16:45,28,10,603240,0
"1253",2018-12-20 14:16:58,28,1000,604240,0.11
"1243",2018-12-20 14:17:32,28,1600,605840,0.17
"1233",2018-12-20 14:17:47,28,1000,606840,0.11
"1223",2018-12-20 14:18:26,28,4400,611240,0.48
"1214",2018-12-20 14:18:30,28,8000,619240,0.86
"1203",2018-12-20 14:18:35,28,5000,624240,0.54
"1193",2018-12-20 14:18:37,28,500,624740,0.05
"1183",2018-12-20 14:18:52,28,300,625040,0.03
"1173",2018-12-20 14:19:00,28,10,625050,0
"1163",2018-12-20 14:19:02,28,6100,631150,0.66
"1153",2018-12-20 14:19:15,28.1,3530,634680,0.38
"1143",2018-12-20 14:21:28,28.1,200,634880,0.02
"1133",2018-12-20 14:23:26,28.1,500,635380,0.05
"1123",2018-12-20 14:23:29,28.1,2000,637380,0.22
"1114",2018-12-20 14:23:33,28.1,60,637440,0.01
"1104",2018-12-20 14:24:31,28.1,1210,638650,0.13
"1093",2018-12-20 14:27:10,28.1,780,639430,0.08
"1083",2018-12-20 14:27:43,28,10,639440,0
"1073",2018-12-20 14:29:26,28.1,3000,642440,0.32
"1063",2018-12-20 14:29:29,28,10000,652440,1.08
"1053",2018-12-20 14:29:30,28,10,652450,0
"1043",2018-12-20 14:29:35,28.1,300,652750,0.03
"1033",2018-12-20 14:31:02,28.05,200,652950,0.02
"1023",2018-12-20 14:31:38,28,1400,654350,0.15
"1014",2018-12-20 14:31:42,28,270,654620,0.03
"1003",2018-12-20 14:32:10,28.05,200,654820,0.02
"993",2018-12-20 14:32:25,28,15000,669820,1.62
"983",2018-12-20 14:32:50,28.05,200,670020,0.02
"973",2018-12-20 14:33:04,28,6460,676480,0.7
"963",2018-12-20 14:33:23,28,180,676660,0.02
"953",2018-12-20 14:33:26,28,1000,677660,0.11
"943",2018-12-20 14:33:33,28.05,20,677680,0
"933",2018-12-20 14:33:42,28,300,677980,0.03
"923",2018-12-20 14:33:44,28,2000,679980,0.22
"914",2018-12-20 14:35:18,28.05,10,679990,0
"903",2018-12-20 14:37:54,28.05,60,680050,0.01
"893",2018-12-20 14:38:05,28,19000,699050,2.05
"883",2018-12-20 14:40:54,28,440,699490,0.05
"873",2018-12-20 14:40:57,28,2000,701490,0.22
"863",2018-12-20 14:43:08,28.05,100,701590,0.01
"853",2018-12-20 14:44:12,28.1,1100,702690,0.12
"843",2018-12-20 14:45:13,28.05,10,702700,0
"833",2018-12-20 14:45:38,28.1,2000,704700,0.22
"823",2018-12-20 14:45:52,28.1,3000,707700,0.32
"814",2018-12-20 14:46:28,28.1,7500,715200,0.81
"803",2018-12-20 14:48:20,28.1,3530,718730,0.38
"793",2018-12-20 14:48:25,28.1,1070,719800,0.12
"783",2018-12-20 14:49:26,28.1,150,719950,0.02
"773",2018-12-20 14:50:26,28.05,1000,720950,0.11
"763",2018-12-20 14:53:52,28.05,270,721220,0.03
"753",2018-12-20 14:53:53,28.05,15000,736220,1.62
"743",2018-12-20 14:53:58,28.05,170,736390,0.02
"733",2018-12-20 14:54:32,28.05,200,736590,0.02
"723",2018-12-20 14:54:36,28.05,10,736600,0
"714",2018-12-20 14:55:44,28.1,510,737110,0.06
"703",2018-12-20 14:55:53,28.1,1000,738110,0.11
"693",2018-12-20 14:56:11,28.1,100,738210,0.01
"683",2018-12-20 14:56:29,28.1,2000,740210,0.22
"673",2018-12-20 14:56:53,28.05,10,740220,0
"663",2018-12-20 14:58:17,28.1,3460,743680,0.37
"653",2018-12-20 15:00:03,28.1,1000,744680,0.11
"643",2018-12-20 15:00:09,28.15,500,745180,0.05
"633",2018-12-20 15:00:20,28.1,60,745240,0.01
"623",2018-12-20 15:01:26,28.15,10000,755240,1.08
"614",2018-12-20 15:01:28,28.1,790,756030,0.09
"603",2018-12-20 15:01:36,28.1,270,756300,0.03
"593",2018-12-20 15:02:05,28.1,1000,757300,0.11
"583",2018-12-20 15:03:13,28.1,1940,759240,0.21
"573",2018-12-20 15:03:27,28.1,270,759510,0.03
"563",2018-12-20 15:03:54,28.15,190,759700,0.02
"553",2018-12-20 15:04:14,28.1,400,760100,0.04
"5410",2018-12-20 15:04:35,28.15,70,760170,0.01
"5312",2018-12-20 15:04:57,28.15,30,760200,0
"5212",2018-12-20 15:05:54,28.15,1000,761200,0.11
"5112",2018-12-20 15:06:00,28.1,70,761270,0.01
"5012",2018-12-20 15:06:05,28.15,900,762170,0.1
"4912",2018-12-20 15:06:07,28.15,8000,770170,0.86
"4812",2018-12-20 15:06:13,28.15,600,770770,0.06
"4712",2018-12-20 15:06:29,28.15,5000,775770,0.54
"4612",2018-12-20 15:06:40,28.15,10,775780,0
"4512",2018-12-20 15:07:32,28.15,500,776280,0.05
"4412",2018-12-20 15:08:18,28.1,790,777070,0.09
"4312",2018-12-20 15:08:29,28.1,11960,789030,1.29
"4212",2018-12-20 15:08:42,28.15,10000,799030,1.08
"4112",2018-12-20 15:11:06,28.2,10200,809230,1.1
"4012",2018-12-20 15:11:14,28.2,2000,811230,0.22
"3912",2018-12-20 15:12:03,28.15,270,811500,0.03
"3813",2018-12-20 15:12:10,28.2,10000,821500,1.08
"3714",2018-12-20 15:12:18,28.2,1000,822500,0.11
"3614",2018-12-20 15:12:30,28.2,70,822570,0.01
"3514",2018-12-20 15:12:37,28.15,10,822580,0
"3415",2018-12-20 15:13:56,28.15,1000,823580,0.11
"3315",2018-12-20 15:14:33,28.15,10000,833580,1.08
"3215",2018-12-20 15:15:03,28.2,1000,834580,0.11
"3115",2018-12-20 15:15:45,28.15,490,835070,0.05
"3015",2018-12-20 15:16:51,28.2,2000,837070,0.22
"2915",2018-12-20 15:17:25,28.2,2020,839090,0.22
"2815",2018-12-20 15:17:30,28.2,100,839190,0.01
"2715",2018-12-20 15:17:32,28.2,10,839200,0
"2615",2018-12-20 15:17:34,28.15,1080,840280,0.12
"2515",2018-12-20 15:20:14,28.15,4000,844280,0.43
"2415",2018-12-20 15:20:23,28.2,6000,850280,0.65
"2315",2018-12-20 15:20:52,28.2,500,850780,0.05
"2215",2018-12-20 15:21:10,28.2,1000,851780,0.11
"2115",2018-12-20 15:21:33,28.2,500,852280,0.05
"2015",2018-12-20 15:21:51,28.15,130,852410,0.01
"1915",2018-12-20 15:22:03,28.2,10,852420,0
"1815",2018-12-20 15:22:20,28.2,110,852530,0.01
"1715",2018-12-20 15:22:57,28.2,3500,856030,0.38
"1615",2018-12-20 15:22:58,28.2,490,856520,0.05
"1515",2018-12-20 15:23:05,28.2,200,856720,0.02
"1415",2018-12-20 15:23:56,28.2,650,857370,0.07
"1315",2018-12-20 15:26:17,28.25,10,857380,0
"1215",2018-12-20 15:27:10,28.2,1040,858420,0.11
"1115",2018-12-20 15:27:32,28.2,1000,859420,0.11
"1015",2018-12-20 15:27:36,28.25,2000,861420,0.22
"915",2018-12-20 15:28:41,28.25,90,861510,0.01
"815",2018-12-20 15:28:43,28.25,1000,862510,0.11
"715",2018-12-20 15:29:17,28.25,1060,863570,0.11
"615",2018-12-20 15:29:23,28.25,3500,867070,0.38
"554",2018-12-20 15:29:26,28.2,3000,870070,0.32
"4102",2018-12-20 15:29:29,28.25,40,870110,0
"3105",2018-12-20 15:29:39,28.25,200,870310,0.02
"2105",2018-12-20 15:30:11,28.2,4500,874810,0.49
"1105",2018-12-20 15:46:29,28.15,50490,925300,5.46
"3054",2018-12-21 10:15:44,28,5160,5160,0.38
"3044",2018-12-21 10:15:50,27.95,180,5340,0.01
"3034",2018-12-21 10:16:36,27.95,460,5800,0.03
"3024",2018-12-21 10:17:00,27.9,500,6300,0.04
"3016",2018-12-21 10:17:02,27.95,2370,8670,0.18
"3004",2018-12-21 10:17:13,27.9,200,8870,0.01
"2994",2018-12-21 10:18:55,27.95,70,8940,0.01
"2984",2018-12-21 10:19:17,27.95,1550,10490,0.12
"2974",2018-12-21 10:22:07,28,3000,13490,0.22
"2964",2018-12-21 10:22:11,27.95,200,13690,0.01
"2954",2018-12-21 10:23:07,27.95,2000,15690,0.15
"2944",2018-12-21 10:23:27,28,8860,24550,0.66
"2934",2018-12-21 10:24:32,28,410,24960,0.03
"2924",2018-12-21 10:25:15,28,10,24970,0
"2916",2018-12-21 10:25:21,28,900,25870,0.07
"2904",2018-12-21 10:26:04,28,1000,26870,0.07
"2894",2018-12-21 10:26:17,28,100,26970,0.01
"2884",2018-12-21 10:26:25,28,5100,32070,0.38
"2874",2018-12-21 10:26:26,28,240,32310,0.02
"2864",2018-12-21 10:27:08,27.95,6000,38310,0.45
"2854",2018-12-21 10:27:27,27.95,100,38410,0.01
"2844",2018-12-21 10:28:01,27.95,2000,40410,0.15
"2834",2018-12-21 10:28:25,27.95,280,40690,0.02
"2824",2018-12-21 10:28:53,27.95,100,40790,0.01
"2816",2018-12-21 10:28:56,27.95,1400,42190,0.1
"2804",2018-12-21 10:30:05,27.95,1220,43410,0.09
"2794",2018-12-21 10:30:51,27.95,200,43610,0.01
"2784",2018-12-21 10:32:10,27.95,600,44210,0.04
"2774",2018-12-21 10:35:30,27.95,20,44230,0
"2764",2018-12-21 10:35:35,27.95,2560,46790,0.19
"2754",2018-12-21 10:35:50,27.95,5000,51790,0.37
"2744",2018-12-21 10:36:12,27.95,5250,57040,0.39
"2734",2018-12-21 10:36:15,27.95,8410,65450,0.63
"2724",2018-12-21 10:37:28,27.95,2370,67820,0.18
"2716",2018-12-21 10:39:28,27.95,5000,72820,0.37
"2704",2018-12-21 10:39:47,27.95,610,73430,0.05
"2694",2018-12-21 10:40:36,27.95,730,74160,0.05
"2684",2018-12-21 10:41:04,27.95,150,74310,0.01
"2674",2018-12-21 10:41:23,27.95,300,74610,0.02
"2664",2018-12-21 10:41:31,27.95,4920,79530,0.37
"2654",2018-12-21 10:41:42,27.95,80,79610,0.01
"2644",2018-12-21 10:41:51,27.95,90,79700,0.01
"2634",2018-12-21 10:42:16,27.95,2280,81980,0.17
"2624",2018-12-21 10:43:07,27.9,900,82880,0.07
"2616",2018-12-21 10:44:34,27.9,2000,84880,0.15
"2604",2018-12-21 10:44:40,28,2160,87040,0.16
"2594",2018-12-21 10:45:09,27.9,500,87540,0.04
"2584",2018-12-21 10:45:20,27.9,300,87840,0.02
"2574",2018-12-21 10:45:21,27.95,500,88340,0.04
"2564",2018-12-21 10:46:37,27.95,6500,94840,0.48
"2554",2018-12-21 10:46:56,27.95,4000,98840,0.3
"2544",2018-12-21 10:47:14,27.95,60,98900,0
"2534",2018-12-21 10:47:33,27.9,800,99700,0.06
"2524",2018-12-21 10:48:32,27.9,10,99710,0
"2516",2018-12-21 10:48:47,27.9,70,99780,0.01
"2504",2018-12-21 10:48:54,27.9,500,100280,0.04
"2494",2018-12-21 10:49:04,27.95,2000,102280,0.15
"2484",2018-12-21 10:50:05,27.95,100,102380,0.01
"2474",2018-12-21 10:50:25,27.95,7200,109580,0.54
"2464",2018-12-21 10:51:33,27.95,100,109680,0.01
"2454",2018-12-21 10:51:37,27.95,10,109690,0
"2444",2018-12-21 10:53:02,28,500,110190,0.04
"2434",2018-12-21 10:53:58,27.95,2250,112440,0.17
"2424",2018-12-21 10:54:23,27.95,5000,117440,0.37
"2416",2018-12-21 10:59:35,27.95,21130,138570,1.57
"2404",2018-12-21 10:59:52,27.95,1000,139570,0.07
"2394",2018-12-21 10:59:55,27.95,500,140070,0.04
"2384",2018-12-21 10:59:59,27.95,30,140100,0
"2374",2018-12-21 11:00:02,27.95,1000,141100,0.07
"2364",2018-12-21 11:00:04,27.95,1340,142440,0.1
"2354",2018-12-21 11:02:44,27.95,110,142550,0.01
"2344",2018-12-21 11:03:12,27.95,10000,152550,0.74
"2334",2018-12-21 11:04:54,28,15000,167550,1.11
"2324",2018-12-21 11:05:02,27.95,890,168440,0.07
"2316",2018-12-21 11:06:01,27.95,3000,171440,0.22
"2304",2018-12-21 11:06:36,27.95,100,171540,0.01
"2294",2018-12-21 11:07:25,27.95,7000,178540,0.52
"2284",2018-12-21 11:07:35,27.95,3000,181540,0.22
"2274",2018-12-21 11:09:30,28,10,181550,0
"2264",2018-12-21 11:10:07,27.95,7000,188550,0.52
"2254",2018-12-21 11:10:24,27.95,5000,193550,0.37
"2244",2018-12-21 11:10:54,27.95,2000,195550,0.15
"2234",2018-12-21 11:11:03,27.95,2090,197640,0.16
"2224",2018-12-21 11:11:46,27.95,1000,198640,0.07
"2216",2018-12-21 11:13:00,27.9,45000,243640,3.34
"2204",2018-12-21 11:13:45,27.95,50,243690,0
"2194",2018-12-21 11:13:58,27.95,500,244190,0.04
"2184",2018-12-21 11:14:45,27.9,10,244200,0
"2174",2018-12-21 11:16:04,27.95,100,244300,0.01
"2164",2018-12-21 11:16:38,27.95,2000,246300,0.15
"2154",2018-12-21 11:17:23,27.95,3000,249300,0.22
"2144",2018-12-21 11:17:29,27.95,500,249800,0.04
"2134",2018-12-21 11:17:35,27.9,30,249830,0
"2124",2018-12-21 11:20:25,27.95,500,250330,0.04
"2116",2018-12-21 11:22:03,27.95,100,250430,0.01
"2106",2018-12-21 11:23:23,27.9,24240,274670,1.8
"2094",2018-12-21 11:24:16,27.85,300,274970,0.02
"2084",2018-12-21 11:26:45,27.85,100,275070,0.01
"2074",2018-12-21 11:26:46,27.9,1500,276570,0.11
"2064",2018-12-21 11:26:53,27.9,500,277070,0.04
"2054",2018-12-21 11:27:34,27.9,1000,278070,0.07
"2044",2018-12-21 11:28:17,27.9,100,278170,0.01
"2034",2018-12-21 11:28:29,27.9,2030,280200,0.15
"2024",2018-12-21 11:31:28,27.95,340,280540,0.03
"2016",2018-12-21 11:32:31,27.9,10,280550,0
"2004",2018-12-21 11:34:19,27.9,210,280760,0.02
"1994",2018-12-21 11:36:11,27.9,500,281260,0.04
"1984",2018-12-21 11:37:30,27.95,4020,285280,0.3
"1974",2018-12-21 11:37:58,27.95,10,285290,0
"1964",2018-12-21 11:39:15,27.95,2370,287660,0.18
"1954",2018-12-21 11:39:16,27.9,9650,297310,0.72
"1944",2018-12-21 11:39:24,27.9,7000,304310,0.52
"1934",2018-12-21 11:39:32,27.9,200,304510,0.01
"1924",2018-12-21 11:40:18,27.95,10,304520,0
"1916",2018-12-21 11:41:52,27.9,1000,305520,0.07
"1904",2018-12-21 11:42:21,27.9,880,306400,0.07
"1894",2018-12-21 11:42:51,27.9,830,307230,0.06
"1884",2018-12-21 11:44:10,27.9,2540,309770,0.19
"1874",2018-12-21 11:45:01,27.9,10,309780,0
"1864",2018-12-21 11:45:43,27.9,100,309880,0.01
"1854",2018-12-21 11:45:55,27.9,10,309890,0
"1844",2018-12-21 11:46:31,27.9,2000,311890,0.15
"1834",2018-12-21 11:46:58,27.85,100,311990,0.01
"1824",2018-12-21 11:47:26,27.9,500,312490,0.04
"1816",2018-12-21 11:47:36,27.9,200,312690,0.01
"1804",2018-12-21 11:47:43,27.9,800,313490,0.06
"1794",2018-12-21 11:48:44,27.9,400,313890,0.03
"1784",2018-12-21 11:51:31,27.9,1800,315690,0.13
"1774",2018-12-21 11:53:59,27.95,1000,316690,0.07
"1764",2018-12-21 11:55:15,27.95,5920,322610,0.44
"1754",2018-12-21 11:55:48,27.95,200,322810,0.01
"1744",2018-12-21 11:58:03,27.95,500,323310,0.04
"1734",2018-12-21 11:58:07,27.95,3820,327130,0.28
"1724",2018-12-21 11:59:12,27.95,10,327140,0
"1716",2018-12-21 12:00:38,27.95,6000,333140,0.45
"1704",2018-12-21 12:01:52,27.95,250,333390,0.02
"1694",2018-12-21 12:02:07,27.95,2840,336230,0.21
"1684",2018-12-21 12:02:23,27.95,20,336250,0
"1674",2018-12-21 12:03:01,27.95,140,336390,0.01
"1664",2018-12-21 12:03:12,27.95,370,336760,0.03
"1654",2018-12-21 12:05:13,28,60,336820,0
"1644",2018-12-21 12:08:34,27.95,7000,343820,0.52
"1634",2018-12-21 12:08:40,27.95,5000,348820,0.37
"1624",2018-12-21 12:09:30,27.95,860,349680,0.06
"1616",2018-12-21 12:12:07,27.95,1400,351080,0.1
"1604",2018-12-21 12:12:13,27.95,700,351780,0.05
"1594",2018-12-21 12:12:27,27.95,2040,353820,0.15
"1584",2018-12-21 12:16:09,27.95,100,353920,0.01
"1574",2018-12-21 12:16:10,28,2370,356290,0.18
"1564",2018-12-21 12:17:07,28,1000,357290,0.07
"1554",2018-12-21 12:17:10,27.95,4360,361650,0.32
"1544",2018-12-21 12:17:24,27.95,140,361790,0.01
"1534",2018-12-21 12:18:50,27.95,500,362290,0.04
"1524",2018-12-21 12:18:52,27.95,360,362650,0.03
"1516",2018-12-21 12:21:42,27.95,50,362700,0
"1504",2018-12-21 12:23:38,27.95,6000,368700,0.45
"1494",2018-12-21 12:23:47,27.95,4000,372700,0.3
"1484",2018-12-21 12:24:19,27.95,50,372750,0
"1474",2018-12-21 12:25:08,27.95,2000,374750,0.15
"1464",2018-12-21 12:27:47,27.95,1650,376400,0.12
"1454",2018-12-21 14:01:18,27.9,28170,404570,2.09
"1444",2018-12-21 14:05:44,27.9,4000,408570,0.3
"1434",2018-12-21 14:05:55,27.9,3120,411690,0.23
"1424",2018-12-21 14:05:57,27.9,300,411990,0.02
"1416",2018-12-21 14:07:50,27.95,100,412090,0.01
"1404",2018-12-21 14:08:04,27.9,10,412100,0
"1394",2018-12-21 14:08:53,27.95,20,412120,0
"1384",2018-12-21 14:09:32,27.95,240,412360,0.02
"1374",2018-12-21 14:14:09,27.95,400,412760,0.03
"1364",2018-12-21 14:15:37,27.95,360,413120,0.03
"1354",2018-12-21 14:16:26,27.95,10,413130,0
"1344",2018-12-21 14:18:08,27.95,2000,415130,0.15
"1334",2018-12-21 14:19:38,27.95,10,415140,0
"1324",2018-12-21 14:21:19,27.95,3000,418140,0.22
"1316",2018-12-21 14:21:50,27.95,50,418190,0
"1304",2018-12-21 14:22:12,27.9,400,418590,0.03
"1294",2018-12-21 14:23:21,27.9,1000,419590,0.07
"1284",2018-12-21 14:24:13,27.9,280,419870,0.02
"1274",2018-12-21 14:24:53,27.9,2000,421870,0.15
"1264",2018-12-21 14:26:16,27.9,7000,428870,0.52
"1254",2018-12-21 14:26:24,27.9,10,428880,0
"1244",2018-12-21 14:26:27,27.9,2700,431580,0.2
"1234",2018-12-21 14:27:03,27.9,7000,438580,0.52
"1224",2018-12-21 14:28:47,27.9,5000,443580,0.37
"1216",2018-12-21 14:29:41,27.9,350,443930,0.03
"1204",2018-12-21 14:30:20,27.9,1200,445130,0.09
"1194",2018-12-21 14:31:24,27.9,15000,460130,1.11
"1184",2018-12-21 14:32:37,27.9,7000,467130,0.52
"1174",2018-12-21 14:33:18,27.9,790,467920,0.06
"1164",2018-12-21 14:34:10,27.9,3110,471030,0.23
"1154",2018-12-21 14:34:43,27.85,850,471880,0.06
"1144",2018-12-21 14:35:02,27.9,2000,473880,0.15
"1134",2018-12-21 14:35:05,27.9,1200,475080,0.09
"1124",2018-12-21 14:35:08,27.9,100,475180,0.01
"1116",2018-12-21 14:37:32,27.9,1100,476280,0.08
"1106",2018-12-21 14:38:12,27.9,5000,481280,0.37
"1094",2018-12-21 14:38:41,27.9,10820,492100,0.8
"1084",2018-12-21 14:40:34,27.9,1200,493300,0.09
"1074",2018-12-21 14:41:01,27.85,300,493600,0.02
"1064",2018-12-21 14:41:50,27.85,580,494180,0.04
"1054",2018-12-21 14:44:21,27.85,1000,495180,0.07
"1044",2018-12-21 14:44:47,27.85,1850,497030,0.14
"1034",2018-12-21 14:45:27,27.85,1100,498130,0.08
"1024",2018-12-21 14:45:36,27.85,900,499030,0.07
"1016",2018-12-21 14:46:01,27.85,1000,500030,0.07
"1004",2018-12-21 14:46:02,27.85,10600,510630,0.79
"994",2018-12-21 14:46:07,27.85,6000,516630,0.45
"984",2018-12-21 14:46:17,27.85,8000,524630,0.59
"974",2018-12-21 14:46:27,27.85,7500,532130,0.56
"964",2018-12-21 14:46:37,27.85,8000,540130,0.59
"954",2018-12-21 14:46:53,27.85,1900,542030,0.14
"944",2018-12-21 14:47:16,27.85,300,542330,0.02
"934",2018-12-21 14:47:21,27.85,3400,545730,0.25
"924",2018-12-21 14:47:51,27.85,500,546230,0.04
"916",2018-12-21 14:49:20,27.85,2750,548980,0.2
"904",2018-12-21 14:49:33,27.85,750,549730,0.06
"894",2018-12-21 14:49:40,27.85,10,549740,0
"884",2018-12-21 14:49:58,27.85,1490,551230,0.11
"874",2018-12-21 14:51:34,27.9,13380,564610,0.99
"864",2018-12-21 14:52:21,27.9,500,565110,0.04
"854",2018-12-21 14:52:53,27.95,2000,567110,0.15
"844",2018-12-21 14:53:30,27.9,370,567480,0.03
"834",2018-12-21 14:54:39,27.95,10140,577620,0.75
"824",2018-12-21 14:54:57,28,2370,579990,0.18
"816",2018-12-21 14:54:59,28,790,580780,0.06
"804",2018-12-21 14:56:34,28,2370,583150,0.18
"794",2018-12-21 14:56:48,27.95,100,583250,0.01
"784",2018-12-21 14:56:58,27.95,10,583260,0
"774",2018-12-21 14:57:19,27.95,5000,588260,0.37
"764",2018-12-21 14:57:27,27.95,2580,590840,0.19
"754",2018-12-21 14:59:02,27.95,2370,593210,0.18
"744",2018-12-21 14:59:39,27.9,10,593220,0
"734",2018-12-21 15:01:50,27.9,400,593620,0.03
"724",2018-12-21 15:01:56,27.95,100,593720,0.01
"716",2018-12-21 15:03:12,27.95,10,593730,0
"704",2018-12-21 15:03:51,27.9,8000,601730,0.59
"694",2018-12-21 15:04:00,27.9,5000,606730,0.37
"684",2018-12-21 15:04:10,27.9,890,607620,0.07
"674",2018-12-21 15:04:17,27.9,4110,611730,0.31
"664",2018-12-21 15:04:24,27.9,60,611790,0
"654",2018-12-21 15:05:23,27.9,3200,614990,0.24
"644",2018-12-21 15:05:38,27.9,20,615010,0
"634",2018-12-21 15:05:43,27.9,30,615040,0
"624",2018-12-21 15:05:59,27.9,100,615140,0.01
"616",2018-12-21 15:06:19,27.9,2650,617790,0.2
"604",2018-12-21 15:07:27,27.9,100,617890,0.01
"594",2018-12-21 15:07:40,27.9,7270,625160,0.54
"584",2018-12-21 15:07:58,27.9,500,625660,0.04
"574",2018-12-21 15:08:03,27.9,300,625960,0.02
"564",2018-12-21 15:08:20,27.9,500,626460,0.04
"555",2018-12-21 15:08:30,27.85,1000,627460,0.07
"5411",2018-12-21 15:08:33,27.9,100,627560,0.01
"5313",2018-12-21 15:08:40,27.9,1000,628560,0.07
"5213",2018-12-21 15:08:49,27.9,2800,631360,0.21
"5113",2018-12-21 15:09:23,27.9,200,631560,0.01
"5013",2018-12-21 15:09:32,27.9,2330,633890,0.17
"4913",2018-12-21 15:10:45,27.9,10000,643890,0.74
"4813",2018-12-21 15:11:03,27.9,6130,650020,0.46
"4713",2018-12-21 15:11:16,27.9,2000,652020,0.15
"4613",2018-12-21 15:11:19,27.9,3000,655020,0.22
"4513",2018-12-21 15:11:39,27.9,3800,658820,0.28
"4413",2018-12-21 15:11:47,27.9,5070,663890,0.38
"4313",2018-12-21 15:12:01,27.95,3000,666890,0.22
"4213",2018-12-21 15:13:31,27.95,9450,676340,0.7
"4113",2018-12-21 15:15:22,27.9,1800,678140,0.13
"4013",2018-12-21 15:16:48,28,50,678190,0
"3913",2018-12-21 15:17:27,27.9,950,679140,0.07
"3814",2018-12-21 15:17:29,27.95,1000,680140,0.07
"3715",2018-12-21 15:18:23,27.9,100,680240,0.01
"3615",2018-12-21 15:18:29,27.9,300,680540,0.02
"3515",2018-12-21 15:18:59,27.9,1000,681540,0.07
"3416",2018-12-21 15:19:15,27.95,10700,692240,0.8
"3316",2018-12-21 15:19:45,27.9,6000,698240,0.45
"3216",2018-12-21 15:19:51,27.95,4100,702340,0.3
"3116",2018-12-21 15:20:04,28,20,702360,0
"3017",2018-12-21 15:20:09,28,2000,704360,0.15
"2917",2018-12-21 15:20:37,28,800,705160,0.06
"2817",2018-12-21 15:21:32,28,1000,706160,0.07
"2717",2018-12-21 15:21:55,28,650,706810,0.05
"2617",2018-12-21 15:21:56,28,110,706920,0.01
"2517",2018-12-21 15:22:01,28,100,707020,0.01
"2417",2018-12-21 15:22:59,27.95,1620,708640,0.12
"2317",2018-12-21 15:23:00,27.95,50,708690,0
"2217",2018-12-21 15:23:21,27.9,1000,709690,0.07
"2117",2018-12-21 15:23:29,27.95,10,709700,0
"2017",2018-12-21 15:23:33,27.95,100,709800,0.01
"1917",2018-12-21 15:23:46,27.9,7000,716800,0.52
"1817",2018-12-21 15:24:40,27.95,100,716900,0.01
"1717",2018-12-21 15:24:56,27.9,2410,719310,0.18
"1617",2018-12-21 15:25:05,27.9,2500,721810,0.19
"1517",2018-12-21 15:25:20,27.9,10,721820,0
"1417",2018-12-21 15:25:47,27.9,50,721870,0
"1317",2018-12-21 15:25:52,27.85,4120,725990,0.31
"1217",2018-12-21 15:26:09,27.9,100,726090,0.01
"1117",2018-12-21 15:27:11,27.9,1610,727700,0.12
"1017",2018-12-21 15:27:20,27.85,5000,732700,0.37
"917",2018-12-21 15:27:25,27.9,100,732800,0.01
"817",2018-12-21 15:27:40,27.9,500,733300,0.04
"717",2018-12-21 15:27:44,27.9,10,733310,0
"617",2018-12-21 15:28:40,27.85,7000,740310,0.52
"556",2018-12-21 15:28:41,27.85,1000,741310,0.07
"4103",2018-12-21 15:28:50,27.9,10,741320,0
"3106",2018-12-21 15:29:16,27.9,100,741420,0.01
"2107",2018-12-21 15:29:21,27.9,3700,745120,0.28
"1107",2018-12-21 15:46:57,27.85,600210,1345330,44.61
"4941",2018-12-24 10:15:46,27.8,7250,7250,0.35
"4931",2018-12-24 10:17:04,27.8,1000,8250,0.05
"4921",2018-12-24 10:17:59,27.85,2500,10750,0.12
"4914",2018-12-24 10:18:59,27.8,400,11150,0.02
"4901",2018-12-24 10:19:12,27.85,100,11250,0
"4891",2018-12-24 10:20:03,27.9,40000,51250,1.92
"4881",2018-12-24 10:20:34,27.9,440,51690,0.02
"4871",2018-12-24 10:21:21,28,5000,56690,0.24
"4861",2018-12-24 10:21:50,28,1000,57690,0.05
"4851",2018-12-24 10:21:51,28,4000,61690,0.19
"4841",2018-12-24 10:21:53,28,1000,62690,0.05
"4831",2018-12-24 10:22:02,28,600,63290,0.03
"4821",2018-12-24 10:22:07,28,100,63390,0
"4814",2018-12-24 10:22:09,27.95,1000,64390,0.05
"4801",2018-12-24 10:22:21,28,5000,69390,0.24
"4791",2018-12-24 10:22:22,27.95,9100,78490,0.44
"4781",2018-12-24 10:22:27,27.95,500,78990,0.02
"4771",2018-12-24 10:22:40,27.95,400,79390,0.02
"4761",2018-12-24 10:22:50,28,2000,81390,0.1
"4751",2018-12-24 10:23:41,28,10000,91390,0.48
"4741",2018-12-24 10:23:52,28,1400,92790,0.07
"4731",2018-12-24 10:23:53,28,400,93190,0.02
"4721",2018-12-24 10:24:14,28,500,93690,0.02
"4714",2018-12-24 10:24:20,28,100,93790,0
"4701",2018-12-24 10:25:28,27.95,950,94740,0.05
"4691",2018-12-24 10:26:36,27.95,3950,98690,0.19
"4681",2018-12-24 10:28:52,27.95,1500,100190,0.07
"4671",2018-12-24 10:29:37,27.9,500,100690,0.02
"4661",2018-12-24 10:29:44,27.95,1500,102190,0.07
"4651",2018-12-24 10:30:18,27.95,30,102220,0
"4641",2018-12-24 10:31:21,27.9,10,102230,0
"4631",2018-12-24 10:32:34,27.9,400,102630,0.02
"4621",2018-12-24 10:34:26,27.9,1180,103810,0.06
"4614",2018-12-24 10:34:54,27.9,9900,113710,0.47
"4601",2018-12-24 10:36:00,27.9,100,113810,0
"4591",2018-12-24 10:36:52,27.9,10000,123810,0.48
"4581",2018-12-24 10:37:15,27.9,100,123910,0
"4571",2018-12-24 10:37:57,27.9,70,123980,0
"4561",2018-12-24 10:38:55,27.9,5000,128980,0.24
"4551",2018-12-24 10:40:59,27.9,20,129000,0
"4541",2018-12-24 10:42:00,27.9,20000,149000,0.96
"4531",2018-12-24 10:42:16,27.9,100,149100,0
"4521",2018-12-24 10:42:28,27.95,2000,151100,0.1
"4514",2018-12-24 10:43:18,27.9,12580,163680,0.6
"4501",2018-12-24 10:44:09,27.85,30000,193680,1.44
"4491",2018-12-24 10:44:32,27.85,1950,195630,0.09
"4481",2018-12-24 10:46:03,27.8,790,196420,0.04
"4471",2018-12-24 10:46:05,27.85,100,196520,0
"4461",2018-12-24 10:46:43,27.8,1320,197840,0.06
"4451",2018-12-24 10:49:11,27.85,1100,198940,0.05
"4441",2018-12-24 10:49:36,27.8,15820,214760,0.76
"4431",2018-12-24 10:50:10,27.8,440,215200,0.02
"4421",2018-12-24 10:50:12,27.8,10,215210,0
"4414",2018-12-24 10:50:20,27.75,100,215310,0
"4401",2018-12-24 10:50:22,27.75,110,215420,0.01
"4391",2018-12-24 10:50:53,27.75,200,215620,0.01
"4381",2018-12-24 10:51:12,27.75,3000,218620,0.14
"4371",2018-12-24 10:51:52,27.75,10,218630,0
"4361",2018-12-24 10:52:26,27.7,500,219130,0.02
"4351",2018-12-24 10:52:29,27.75,600,219730,0.03
"4341",2018-12-24 10:52:30,27.75,30,219760,0
"4331",2018-12-24 10:53:10,27.7,210,219970,0.01
"4321",2018-12-24 10:53:47,27.75,1000,220970,0.05
"4314",2018-12-24 10:54:00,27.75,1980,222950,0.09
"4301",2018-12-24 10:57:01,27.75,10000,232950,0.48
"4291",2018-12-24 10:57:39,27.75,3000,235950,0.14
"4281",2018-12-24 10:59:40,27.75,1600,237550,0.08
"4271",2018-12-24 11:00:40,27.75,2000,239550,0.1
"4261",2018-12-24 11:00:57,27.75,2180,241730,0.1
"4251",2018-12-24 11:02:00,27.75,790,242520,0.04
"4241",2018-12-24 11:02:13,27.75,1000,243520,0.05
"4231",2018-12-24 11:02:16,27.7,820,244340,0.04
"4221",2018-12-24 11:03:16,27.7,1600,245940,0.08
"4214",2018-12-24 11:03:51,27.75,30,245970,0
"4201",2018-12-24 11:04:11,27.75,110,246080,0.01
"4191",2018-12-24 11:04:25,27.7,10000,256080,0.48
"4181",2018-12-24 11:04:27,27.7,2000,258080,0.1
"4171",2018-12-24 11:05:17,27.7,6750,264830,0.32
"4161",2018-12-24 11:05:30,27.7,500,265330,0.02
"4151",2018-12-24 11:06:45,27.7,30,265360,0
"4141",2018-12-24 11:06:52,27.65,1600,266960,0.08
"4131",2018-12-24 11:07:47,27.65,110,267070,0.01
"4121",2018-12-24 11:08:11,27.65,1440,268510,0.07
"4114",2018-12-24 11:08:18,27.65,210,268720,0.01
"4104",2018-12-24 11:08:39,27.65,1830,270550,0.09
"4091",2018-12-24 11:10:28,27.65,1070,271620,0.05
"4081",2018-12-24 11:10:45,27.6,10,271630,0
"4071",2018-12-24 11:10:46,27.65,30,271660,0
"4061",2018-12-24 11:11:18,27.65,500,272160,0.02
"4051",2018-12-24 11:11:32,27.6,10000,282160,0.48
"4041",2018-12-24 11:11:39,27.6,6000,288160,0.29
"4031",2018-12-24 11:13:11,27.6,250,288410,0.01
"4021",2018-12-24 11:13:32,27.6,30,288440,0
"4014",2018-12-24 11:14:04,27.6,1600,290040,0.08
"4001",2018-12-24 11:14:09,27.6,4570,294610,0.22
"3991",2018-12-24 11:14:13,27.6,900,295510,0.04
"3981",2018-12-24 11:14:24,27.6,830,296340,0.04
"3971",2018-12-24 11:15:39,27.7,1000,297340,0.05
"3961",2018-12-24 11:16:00,27.7,200,297540,0.01
"3951",2018-12-24 11:17:27,27.7,500,298040,0.02
"3941",2018-12-24 11:17:39,27.65,1600,299640,0.08
"3931",2018-12-24 11:18:35,27.65,6000,305640,0.29
"3921",2018-12-24 11:18:40,27.65,3000,308640,0.14
"3914",2018-12-24 11:18:46,27.65,100,308740,0
"3901",2018-12-24 11:19:52,27.7,80,308820,0
"3891",2018-12-24 11:20:07,27.65,330,309150,0.02
"3881",2018-12-24 11:21:15,27.65,1600,310750,0.08
"3871",2018-12-24 11:22:53,27.65,1500,312250,0.07
"3861",2018-12-24 11:24:51,27.65,1600,313850,0.08
"3851",2018-12-24 11:25:12,27.65,5000,318850,0.24
"3841",2018-12-24 11:26:36,27.65,10,318860,0
"3831",2018-12-24 11:28:27,27.65,1600,320460,0.08
"3822",2018-12-24 11:29:51,27.65,4300,324760,0.21
"3815",2018-12-24 11:30:55,27.65,100,324860,0
"3802",2018-12-24 11:31:05,27.65,400,325260,0.02
"3792",2018-12-24 11:32:03,27.65,1600,326860,0.08
"3782",2018-12-24 11:33:26,27.65,8920,335780,0.43
"3773",2018-12-24 11:33:37,27.7,1000,336780,0.05
"3763",2018-12-24 11:34:16,27.65,100,336880,0
"3753",2018-12-24 11:34:41,27.7,1000,337880,0.05
"3743",2018-12-24 11:34:47,27.6,46000,383880,2.2
"3733",2018-12-24 11:35:39,27.65,1000,384880,0.05
"3723",2018-12-24 11:35:48,27.65,600,385480,0.03
"3716",2018-12-24 11:36:05,27.7,3000,388480,0.14
"3703",2018-12-24 11:36:56,27.7,20,388500,0
"3693",2018-12-24 11:37:05,27.65,7000,395500,0.34
"3683",2018-12-24 11:39:15,27.65,8600,404100,0.41
"3673",2018-12-24 11:40:31,27.7,2000,406100,0.1
"3663",2018-12-24 11:41:00,27.7,2370,408470,0.11
"3653",2018-12-24 11:41:04,27.65,1600,410070,0.08
"3643",2018-12-24 11:41:36,27.65,18710,428780,0.9
"3633",2018-12-24 11:41:52,27.6,10,428790,0
"3623",2018-12-24 11:42:51,27.6,1600,430390,0.08
"3616",2018-12-24 11:43:46,27.65,2000,432390,0.1
"3603",2018-12-24 11:44:58,27.65,300,432690,0.01
"3593",2018-12-24 11:45:31,27.65,1000,433690,0.05
"3583",2018-12-24 11:46:26,27.6,1600,435290,0.08
"3573",2018-12-24 11:46:36,27.6,3600,438890,0.17
"3563",2018-12-24 11:46:56,27.65,100,438990,0
"3553",2018-12-24 11:48:15,27.65,50,439040,0
"3543",2018-12-24 11:49:13,27.65,100,439140,0
"3533",2018-12-24 11:49:57,27.65,110,439250,0.01
"3523",2018-12-24 11:50:02,27.6,1600,440850,0.08
"3516",2018-12-24 11:50:45,27.65,10,440860,0
"3503",2018-12-24 11:51:41,27.65,100,440960,0
"3494",2018-12-24 11:53:03,27.65,30,440990,0
"3484",2018-12-24 11:53:38,27.6,1600,442590,0.08
"3474",2018-12-24 11:53:44,27.65,5000,447590,0.24
"3464",2018-12-24 11:55:07,27.65,4410,452000,0.21
"3454",2018-12-24 11:55:24,27.65,50,452050,0
"3444",2018-12-24 11:55:43,27.65,300,452350,0.01
"3434",2018-12-24 11:56:08,27.65,10,452360,0
"3424",2018-12-24 11:56:16,27.65,10000,462360,0.48
"3417",2018-12-24 11:56:26,27.65,2320,464680,0.11
"3404",2018-12-24 11:56:41,27.65,1180,465860,0.06
"3394",2018-12-24 11:57:14,27.6,1600,467460,0.08
"3384",2018-12-24 11:57:32,27.65,500,467960,0.02
"3374",2018-12-24 11:58:00,27.65,520,468480,0.02
"3364",2018-12-24 11:58:10,27.6,10,468490,0
"3354",2018-12-24 11:58:41,27.65,100,468590,0
"3344",2018-12-24 11:59:02,27.65,220,468810,0.01
"3334",2018-12-24 11:59:13,27.6,1000,469810,0.05
"3324",2018-12-24 12:00:50,27.6,1600,471410,0.08
"3317",2018-12-24 12:01:19,27.6,390,471800,0.02
"3304",2018-12-24 12:02:52,27.65,360,472160,0.02
"3294",2018-12-24 12:03:03,27.65,100,472260,0
"3284",2018-12-24 12:03:09,27.65,4180,476440,0.2
"3274",2018-12-24 12:03:50,27.65,100,476540,0
"3264",2018-12-24 12:04:04,27.65,30,476570,0
"3254",2018-12-24 12:04:26,27.6,1600,478170,0.08
"3244",2018-12-24 12:04:31,27.65,50,478220,0
"3234",2018-12-24 12:05:24,27.65,100,478320,0
"3224",2018-12-24 12:07:39,27.6,10,478330,0
"3217",2018-12-24 12:08:02,27.6,4430,482760,0.21
"3204",2018-12-24 12:08:29,27.6,20,482780,0
"3194",2018-12-24 12:08:54,27.65,13780,496560,0.66
"3184",2018-12-24 12:11:40,27.6,1600,498160,0.08
"3174",2018-12-24 12:14:29,27.65,50,498210,0
"3164",2018-12-24 12:15:13,27.65,2600,500810,0.12
"3154",2018-12-24 12:15:46,27.65,500,501310,0.02
"3144",2018-12-24 12:15:58,27.65,2910,504220,0.14
"3134",2018-12-24 12:16:21,27.65,5000,509220,0.24
"3124",2018-12-24 12:16:26,27.65,100,509320,0
"3117",2018-12-24 12:16:44,27.65,670,509990,0.03
"3107",2018-12-24 12:17:23,27.65,330,510320,0.02
"3094",2018-12-24 12:18:49,27.6,1600,511920,0.08
"3084",2018-12-24 12:18:52,27.65,10570,522490,0.51
"3074",2018-12-24 12:19:44,27.65,40,522530,0
"3064",2018-12-24 12:20:15,27.7,2370,524900,0.11
"3055",2018-12-24 12:21:08,27.65,8370,533270,0.4
"3045",2018-12-24 12:21:13,27.65,3000,536270,0.14
"3035",2018-12-24 12:21:29,27.65,100,536370,0
"3025",2018-12-24 12:22:27,27.65,1700,538070,0.08
"3018",2018-12-24 12:23:02,27.65,1000,539070,0.05
"3005",2018-12-24 12:24:23,27.65,3500,542570,0.17
"2995",2018-12-24 12:25:53,27.65,500,543070,0.02
"2985",2018-12-24 12:26:01,27.65,1600,544670,0.08
"2975",2018-12-24 12:26:11,27.65,200,544870,0.01
"2965",2018-12-24 12:26:43,27.6,17970,562840,0.86
"2955",2018-12-24 12:27:27,27.7,12200,575040,0.58
"2945",2018-12-24 12:27:42,27.65,200,575240,0.01
"2935",2018-12-24 12:30:12,27.65,300,575540,0.01
"2925",2018-12-24 14:01:13,27.6,29500,605040,1.41
"2918",2018-12-24 14:01:18,27.55,1600,606640,0.08
"2905",2018-12-24 14:02:38,27.6,2370,609010,0.11
"2895",2018-12-24 14:02:50,27.55,30,609040,0
"2885",2018-12-24 14:03:08,27.6,100,609140,0
"2875",2018-12-24 14:03:18,27.6,20,609160,0
"2865",2018-12-24 14:04:04,27.6,2370,611530,0.11
"2855",2018-12-24 14:04:31,27.55,1600,613130,0.08
"2845",2018-12-24 14:05:18,27.6,500,613630,0.02
"2835",2018-12-24 14:05:32,27.6,130,613760,0.01
"2825",2018-12-24 14:07:16,27.5,63000,676760,3.02
"2818",2018-12-24 14:07:19,27.6,10,676770,0
"2805",2018-12-24 14:08:01,27.5,1600,678370,0.08
"2795",2018-12-24 14:08:37,27.6,200,678570,0.01
"2785",2018-12-24 14:08:46,27.5,20000,698570,0.96
"2775",2018-12-24 14:08:57,27.5,10,698580,0
"2765",2018-12-24 14:10:43,27.5,30,698610,0
"2755",2018-12-24 14:11:06,27.6,1000,699610,0.05
"2745",2018-12-24 14:11:33,27.55,200,699810,0.01
"2735",2018-12-24 14:12:07,27.55,40,699850,0
"2725",2018-12-24 14:12:14,27.55,50,699900,0
"2718",2018-12-24 14:13:05,27.55,550,700450,0.03
"2705",2018-12-24 14:15:04,27.5,1600,702050,0.08
"2695",2018-12-24 14:15:07,27.55,3000,705050,0.14
"2685",2018-12-24 14:15:16,27.55,300,705350,0.01
"2675",2018-12-24 14:16:16,27.55,10,705360,0
"2665",2018-12-24 14:16:30,27.55,200,705560,0.01
"2655",2018-12-24 14:16:40,27.55,100,705660,0
"2645",2018-12-24 14:16:55,27.55,1150,706810,0.06
"2635",2018-12-24 14:18:33,27.55,1600,708410,0.08
"2625",2018-12-24 14:20:02,27.55,940,709350,0.05
"2618",2018-12-24 14:20:08,27.6,800,710150,0.04
"2605",2018-12-24 14:20:32,27.6,70,710220,0
"2595",2018-12-24 14:21:08,27.6,5000,715220,0.24
"2585",2018-12-24 14:21:43,27.6,2370,717590,0.11
"2575",2018-12-24 14:21:45,27.6,700,718290,0.03
"2565",2018-12-24 14:21:51,27.6,31660,749950,1.52
"2555",2018-12-24 14:21:54,27.6,500,750450,0.02
"2545",2018-12-24 14:22:01,27.6,1600,752050,0.08
"2535",2018-12-24 14:22:11,27.6,7030,759080,0.34
"2525",2018-12-24 14:22:38,27.65,2370,761450,0.11
"2518",2018-12-24 14:23:08,27.6,200,761650,0.01
"2505",2018-12-24 14:23:39,27.65,30,761680,0
"2495",2018-12-24 14:23:58,27.65,50,761730,0
"2485",2018-12-24 14:24:08,27.65,30,761760,0
"2475",2018-12-24 14:24:42,27.6,100,761860,0
"2465",2018-12-24 14:25:20,27.65,1000,762860,0.05
"2455",2018-12-24 14:25:31,27.6,1600,764460,0.08
"2445",2018-12-24 14:25:45,27.6,12000,776460,0.57
"2435",2018-12-24 14:25:50,27.6,6000,782460,0.29
"2425",2018-12-24 14:27:07,27.6,1000,783460,0.05
"2418",2018-12-24 14:27:19,27.6,1850,785310,0.09
"2405",2018-12-24 14:28:14,27.6,1150,786460,0.06
"2395",2018-12-24 14:29:01,27.6,850,787310,0.04
"2385",2018-12-24 14:29:59,27.6,750,788060,0.04
"2375",2018-12-24 14:30:08,27.6,250,788310,0.01
"2365",2018-12-24 14:30:33,27.6,10000,798310,0.48
"2355",2018-12-24 14:30:40,27.6,200,798510,0.01
"2345",2018-12-24 14:31:09,27.6,20,798530,0
"2335",2018-12-24 14:31:31,27.6,10,798540,0
"2325",2018-12-24 14:32:21,27.55,2100,800640,0.1
"2318",2018-12-24 14:32:27,27.6,200,800840,0.01
"2305",2018-12-24 14:32:33,27.55,1600,802440,0.08
"2295",2018-12-24 14:32:49,27.55,700,803140,0.03
"2285",2018-12-24 14:33:25,27.6,3000,806140,0.14
"2275",2018-12-24 14:35:04,27.6,1000,807140,0.05
"2265",2018-12-24 14:36:01,27.55,2600,809740,0.12
"2255",2018-12-24 14:36:04,27.6,1000,810740,0.05
"2245",2018-12-24 14:36:38,27.55,500,811240,0.02
"2235",2018-12-24 14:37:10,27.55,10,811250,0
"2225",2018-12-24 14:37:19,27.55,2000,813250,0.1
"2218",2018-12-24 14:37:28,27.6,100,813350,0
"2205",2018-12-24 14:39:13,27.55,3000,816350,0.14
"2195",2018-12-24 14:39:32,27.55,1600,817950,0.08
"2185",2018-12-24 14:39:39,27.55,26000,843950,1.25
"2175",2018-12-24 14:40:25,27.55,15000,858950,0.72
"2165",2018-12-24 14:40:48,27.55,2000,860950,0.1
"2155",2018-12-24 14:41:00,27.55,4060,865010,0.19
"2145",2018-12-24 14:41:04,27.55,2000,867010,0.1
"2135",2018-12-24 14:41:48,27.55,1000,868010,0.05
"2125",2018-12-24 14:42:07,27.55,1100,869110,0.05
"2118",2018-12-24 14:42:22,27.55,310,869420,0.01
"2108",2018-12-24 14:42:33,27.55,100,869520,0
"2095",2018-12-24 14:43:01,27.5,1600,871120,0.08
"2085",2018-12-24 14:43:42,27.55,100,871220,0
"2075",2018-12-24 14:44:14,27.55,300,871520,0.01
"2065",2018-12-24 14:44:58,27.55,2370,873890,0.11
"2055",2018-12-24 14:44:59,27.55,60,873950,0
"2045",2018-12-24 14:45:21,27.55,500,874450,0.02
"2035",2018-12-24 14:45:28,27.55,30,874480,0
"2025",2018-12-24 14:45:45,27.55,1000,875480,0.05
"2018",2018-12-24 14:45:53,27.55,2070,877550,0.1
"2005",2018-12-24 14:46:29,27.55,300,877850,0.01
"1995",2018-12-24 14:46:31,27.5,1600,879450,0.08
"1985",2018-12-24 14:47:16,27.55,500,879950,0.02
"1975",2018-12-24 14:47:24,27.5,50,880000,0
"1965",2018-12-24 14:48:23,27.55,500,880500,0.02
"1955",2018-12-24 14:50:01,27.5,1600,882100,0.08
"1945",2018-12-24 14:50:13,27.55,10000,892100,0.48
"1935",2018-12-24 14:50:54,27.55,100,892200,0
"1925",2018-12-24 14:51:03,27.55,1600,893800,0.08
"1918",2018-12-24 14:51:07,27.55,500,894300,0.02
"1905",2018-12-24 14:51:09,27.55,100,894400,0
"1895",2018-12-24 14:51:28,27.55,2160,896560,0.1
"1885",2018-12-24 14:51:30,27.55,2850,899410,0.14
"1875",2018-12-24 14:51:34,27.55,2150,901560,0.1
"1865",2018-12-24 14:51:36,27.55,390,901950,0.02
"1855",2018-12-24 14:52:59,27.6,100,902050,0
"1845",2018-12-24 14:53:03,27.5,10000,912050,0.48
"1835",2018-12-24 14:53:31,27.5,1600,913650,0.08
"1825",2018-12-24 14:53:54,27.6,2000,915650,0.1
"1818",2018-12-24 14:54:59,27.5,12000,927650,0.57
"1805",2018-12-24 14:55:11,27.55,20,927670,0
"1795",2018-12-24 14:55:21,27.55,2370,930040,0.11
"1785",2018-12-24 14:56:02,27.55,610,930650,0.03
"1775",2018-12-24 14:56:27,27.5,8780,939430,0.42
"1765",2018-12-24 14:56:28,27.5,500,939930,0.02
"1755",2018-12-24 14:56:38,27.55,200,940130,0.01
"1745",2018-12-24 14:57:02,27.55,1600,941730,0.08
"1735",2018-12-24 14:57:43,27.6,100,941830,0
"1725",2018-12-24 14:59:09,27.5,20000,961830,0.96
"1718",2018-12-24 14:59:23,27.5,16460,978290,0.79
"1705",2018-12-24 14:59:40,27.45,20000,998290,0.96
"1695",2018-12-24 14:59:41,27.5,50,998340,0
"1685",2018-12-24 14:59:43,27.5,500,998840,0.02
"1675",2018-12-24 14:59:45,27.5,200,999040,0.01
"1665",2018-12-24 14:59:56,27.5,610,999650,0.03
"1655",2018-12-24 15:00:31,27.45,1600,1001250,0.08
"1645",2018-12-24 15:00:35,27.5,500,1001750,0.02
"1635",2018-12-24 15:00:40,27.45,320,1002070,0.02
"1625",2018-12-24 15:00:41,27.5,500,1002570,0.02
"1618",2018-12-24 15:03:05,27.45,7500,1010070,0.36
"1605",2018-12-24 15:03:12,27.45,3000,1013070,0.14
"1595",2018-12-24 15:03:14,27.5,10,1013080,0
"1585",2018-12-24 15:03:53,27.45,3950,1017030,0.19
"1575",2018-12-24 15:03:59,27.45,2050,1019080,0.1
"1565",2018-12-24 15:04:01,27.45,1600,1020680,0.08
"1555",2018-12-24 15:04:19,27.5,1000,1021680,0.05
"1545",2018-12-24 15:04:24,27.45,4000,1025680,0.19
"1535",2018-12-24 15:05:10,27.5,900,1026580,0.04
"1525",2018-12-24 15:05:27,27.5,100,1026680,0
"1518",2018-12-24 15:05:39,27.45,3900,1030580,0.19
"1505",2018-12-24 15:05:42,27.45,130,1030710,0.01
"1495",2018-12-24 15:05:43,27.45,20000,1050710,0.96
"1485",2018-12-24 15:05:57,27.5,110,1050820,0.01
"1475",2018-12-24 15:06:20,27.5,100,1050920,0
"1465",2018-12-24 15:07:13,27.45,4500,1055420,0.22
"1455",2018-12-24 15:07:17,27.4,66140,1121560,3.17
"1445",2018-12-24 15:07:31,27.35,1600,1123160,0.08
"1435",2018-12-24 15:07:48,27.35,100,1123260,0
"1425",2018-12-24 15:07:57,27.35,3100,1126360,0.15
"1418",2018-12-24 15:08:01,27.35,2720,1129080,0.13
"1405",2018-12-24 15:08:20,27.3,1000,1130080,0.05
"1395",2018-12-24 15:08:22,27.3,40,1130120,0
"1385",2018-12-24 15:08:33,27.35,50,1130170,0
"1375",2018-12-24 15:08:52,27.35,100,1130270,0
"1365",2018-12-24 15:08:54,27.35,30,1130300,0
"1355",2018-12-24 15:09:05,27.35,1000,1131300,0.05
"1345",2018-12-24 15:09:06,27.35,1100,1132400,0.05
"1335",2018-12-24 15:09:15,27.35,2000,1134400,0.1
"1325",2018-12-24 15:09:20,27.3,1000,1135400,0.05
"1318",2018-12-24 15:09:47,27.35,10,1135410,0
"1305",2018-12-24 15:10:39,27.4,5000,1140410,0.24
"1295",2018-12-24 15:10:53,27.35,1000,1141410,0.05
"1285",2018-12-24 15:11:02,27.35,630,1142040,0.03
"1275",2018-12-24 15:11:10,27.35,970,1143010,0.05
"1265",2018-12-24 15:11:16,27.35,300,1143310,0.01
"1255",2018-12-24 15:11:25,27.35,2730,1146040,0.13
"1245",2018-12-24 15:11:42,27.35,10,1146050,0
"1235",2018-12-24 15:11:47,27.35,220,1146270,0.01
"1225",2018-12-24 15:13:17,27.35,2000,1148270,0.1
"1218",2018-12-24 15:13:23,27.4,60,1148330,0
"1205",2018-12-24 15:13:24,27.35,100,1148430,0
"1195",2018-12-24 15:14:04,27.35,2030,1150460,0.1
"1185",2018-12-24 15:14:14,27.35,20,1150480,0
"1175",2018-12-24 15:14:31,27.3,4300,1154780,0.21
"1165",2018-12-24 15:14:35,27.35,2370,1157150,0.11
"1155",2018-12-24 15:14:36,27.35,50,1157200,0
"1145",2018-12-24 15:14:59,27.3,6000,1163200,0.29
"1135",2018-12-24 15:15:01,27.3,25780,1188980,1.23
"1125",2018-12-24 15:15:15,27.25,10,1188990,0
"1118",2018-12-24 15:15:19,27.25,1500,1190490,0.07
"1108",2018-12-24 15:15:20,27.3,2370,1192860,0.11
"1095",2018-12-24 15:15:32,27.3,450,1193310,0.02
"1085",2018-12-24 15:15:37,27.35,630,1193940,0.03
"1075",2018-12-24 15:16:08,27.35,1000,1194940,0.05
"1065",2018-12-24 15:16:19,27.4,90,1195030,0
"1055",2018-12-24 15:16:26,27.35,1590,1196620,0.08
"1045",2018-12-24 15:16:32,27.35,1780,1198400,0.09
"1035",2018-12-24 15:16:48,27.35,1690,1200090,0.08
"1025",2018-12-24 15:16:58,27.35,30,1200120,0
"1018",2018-12-24 15:17:21,27.3,4000,1204120,0.19
"1005",2018-12-24 15:17:31,27.3,130,1204250,0.01
"995",2018-12-24 15:17:35,27.3,950,1205200,0.05
"985",2018-12-24 15:17:45,27.3,500,1205700,0.02
"975",2018-12-24 15:17:46,27.3,10,1205710,0
"965",2018-12-24 15:17:51,27.3,410,1206120,0.02
"955",2018-12-24 15:18:01,27.3,1600,1207720,0.08
"945",2018-12-24 15:18:46,27.3,500,1208220,0.02
"935",2018-12-24 15:18:55,27.3,4000,1212220,0.19
"925",2018-12-24 15:19:57,27.3,150,1212370,0.01
"918",2018-12-24 15:19:58,27.25,10,1212380,0
"905",2018-12-24 15:20:08,27.3,900,1213280,0.04
"895",2018-12-24 15:20:13,27.3,200,1213480,0.01
"885",2018-12-24 15:20:19,27.3,1000,1214480,0.05
"875",2018-12-24 15:20:24,27.3,200,1214680,0.01
"865",2018-12-24 15:20:26,27.3,500,1215180,0.02
"855",2018-12-24 15:20:42,27.2,73110,1288290,3.5
"845",2018-12-24 15:20:44,27.2,20,1288310,0
"835",2018-12-24 15:20:47,27.2,100,1288410,0
"825",2018-12-24 15:21:06,27.2,80,1288490,0
"818",2018-12-24 15:21:07,27.15,1000,1289490,0.05
"805",2018-12-24 15:21:11,27.2,1500,1290990,0.07
"795",2018-12-24 15:21:13,27.15,13000,1303990,0.62
"785",2018-12-24 15:21:19,27.2,5000,1308990,0.24
"775",2018-12-24 15:21:27,27.15,3590,1312580,0.17
"765",2018-12-24 15:21:28,27.2,100,1312680,0
"755",2018-12-24 15:21:31,27.15,610,1313290,0.03
"745",2018-12-24 15:21:35,27.15,990,1314280,0.05
"735",2018-12-24 15:21:37,27.15,10,1314290,0
"725",2018-12-24 15:21:42,27.2,1000,1315290,0.05
"718",2018-12-24 15:21:43,27.1,10000,1325290,0.48
"705",2018-12-24 15:21:49,27.15,150,1325440,0.01
"695",2018-12-24 15:21:55,27.15,1000,1326440,0.05
"685",2018-12-24 15:21:59,27.15,30,1326470,0
"675",2018-12-24 15:22:01,27.15,50,1326520,0
"665",2018-12-24 15:22:02,27.15,1000,1327520,0.05
"655",2018-12-24 15:22:06,27.15,780,1328300,0.04
"645",2018-12-24 15:22:11,27.15,20,1328320,0
"635",2018-12-24 15:22:15,27.15,50,1328370,0
"625",2018-12-24 15:22:24,27.15,1000,1329370,0.05
"618",2018-12-24 15:22:32,27.15,40,1329410,0
"605",2018-12-24 15:22:34,27.15,20,1329430,0
"595",2018-12-24 15:22:35,27.15,600,1330030,0.03
"585",2018-12-24 15:22:36,27.15,1000,1331030,0.05
"575",2018-12-24 15:22:52,27.15,20,1331050,0
"565",2018-12-24 15:22:54,27.15,40,1331090,0
"557",2018-12-24 15:23:01,27.15,1020,1332110,0.05
"5412",2018-12-24 15:23:05,27.15,5000,1337110,0.24
"5314",2018-12-24 15:23:09,27.15,1290,1338400,0.06
"5214",2018-12-24 15:23:17,27.2,100,1338500,0
"5114",2018-12-24 15:23:18,27.05,57790,1396290,2.77
"5014",2018-12-24 15:23:52,27.15,10,1396300,0
"4915",2018-12-24 15:23:53,27,60000,1456300,2.87
"4815",2018-12-24 15:23:59,27.2,490,1456790,0.02
"4715",2018-12-24 15:24:04,27.15,5000,1461790,0.24
"4615",2018-12-24 15:24:35,27.15,2000,1463790,0.1
"4515",2018-12-24 15:24:36,27.2,10,1463800,0
"4415",2018-12-24 15:24:37,27,230910,1694710,11.06
"4315",2018-12-24 15:24:40,27,200,1694910,0.01
"4215",2018-12-24 15:24:47,27,5000,1699910,0.24
"4115",2018-12-24 15:24:53,26.9,400,1700310,0.02
"4015",2018-12-24 15:24:56,27,610,1700920,0.03
"3915",2018-12-24 15:24:58,27,500,1701420,0.02
"3816",2018-12-24 15:25:01,26.9,1600,1703020,0.08
"3717",2018-12-24 15:25:02,27,100,1703120,0
"3617",2018-12-24 15:25:11,27,3100,1706220,0.15
"3517",2018-12-24 15:25:14,27,2700,1708920,0.13
"3418",2018-12-24 15:25:21,27,30,1708950,0
"3318",2018-12-24 15:25:22,27,100,1709050,0
"3218",2018-12-24 15:25:33,27,15000,1724050,0.72
"3118",2018-12-24 15:25:39,26.9,10,1724060,0
"3019",2018-12-24 15:25:43,27,7450,1731510,0.36
"2919",2018-12-24 15:25:57,27.15,1000,1732510,0.05
"2819",2018-12-24 15:26:05,27.15,2000,1734510,0.1
"2719",2018-12-24 15:26:47,27.15,80,1734590,0
"2619",2018-12-24 15:26:50,27.2,20,1734610,0
"2519",2018-12-24 15:26:51,27.2,500,1735110,0.02
"2419",2018-12-24 15:26:53,27.2,9110,1744220,0.44
"2319",2018-12-24 15:26:55,27.15,10000,1754220,0.48
"2219",2018-12-24 15:27:00,27.15,2360,1756580,0.11
"2119",2018-12-24 15:27:06,27.15,500,1757080,0.02
"2019",2018-12-24 15:27:11,27.15,100,1757180,0
"1919",2018-12-24 15:27:16,27.35,11870,1769050,0.57
"1819",2018-12-24 15:27:24,27.35,1450,1770500,0.07
"1719",2018-12-24 15:27:33,27.35,1000,1771500,0.05
"1619",2018-12-24 15:27:41,27.35,400,1771900,0.02
"1519",2018-12-24 15:28:02,27.4,10,1771910,0
"1419",2018-12-24 15:28:16,27.4,1000,1772910,0.05
"1319",2018-12-24 15:28:21,27.5,20000,1792910,0.96
"1219",2018-12-24 15:28:40,27.4,1000,1793910,0.05
"1119",2018-12-24 15:29:03,27.4,1130,1795040,0.05
"1019",2018-12-24 15:29:05,27.35,5000,1800040,0.24
"919",2018-12-24 15:29:06,27.4,870,1800910,0.04
"819",2018-12-24 15:29:11,27.35,5000,1805910,0.24
"719",2018-12-24 15:29:24,27.35,2000,1807910,0.1
"619",2018-12-24 15:29:30,27.35,2170,1810080,0.1
"558",2018-12-24 15:29:40,27.3,400,1810480,0.02
"4105",2018-12-24 15:29:41,27.3,20,1810500,0
"3108",2018-12-24 15:29:51,27.5,10000,1820500,0.48
"2109",2018-12-24 15:30:12,27.5,3390,1823890,0.16
"1109",2018-12-24 15:46:30,27,263690,2087580,12.63
"900",2018-12-25 10:15:30,26.45,44610,44610,1.59
"899",2018-12-25 10:15:38,26.5,1390,46000,0.05
"898",2018-12-25 10:16:07,26.45,340,46340,0.01
"897",2018-12-25 10:16:43,26.45,1000,47340,0.04
"896",2018-12-25 10:16:53,26.5,100,47440,0
"8951",2018-12-25 10:16:57,26.45,3000,50440,0.11
"8941",2018-12-25 10:16:59,26.45,6310,56750,0.23
"8931",2018-12-25 10:17:04,26.45,100,56850,0
"8921",2018-12-25 10:17:17,26.45,2420,59270,0.09
"8911",2018-12-25 10:17:19,26.45,100,59370,0
"890",2018-12-25 10:17:28,26.45,200,59570,0.01
"889",2018-12-25 10:17:33,26.45,1000,60570,0.04
"888",2018-12-25 10:17:50,26.45,100,60670,0
"887",2018-12-25 10:18:01,26.4,10000,70670,0.36
"886",2018-12-25 10:18:11,26.4,450,71120,0.02
"8851",2018-12-25 10:18:21,26.45,2000,73120,0.07
"8841",2018-12-25 10:18:29,26.4,8510,81630,0.3
"8831",2018-12-25 10:18:37,26.4,500,82130,0.02
"8821",2018-12-25 10:18:39,26.4,200,82330,0.01
"8811",2018-12-25 10:18:45,26.4,20,82350,0
"880",2018-12-25 10:19:24,26.4,200,82550,0.01
"879",2018-12-25 10:19:28,26.4,500,83050,0.02
"878",2018-12-25 10:19:34,26.4,1500,84550,0.05
"877",2018-12-25 10:19:41,26.4,40,84590,0
"876",2018-12-25 10:19:49,26.4,5000,89590,0.18
"8751",2018-12-25 10:19:51,26.4,200,89790,0.01
"8741",2018-12-25 10:20:01,26.4,500,90290,0.02
"8731",2018-12-25 10:20:16,26.3,20000,110290,0.71
"8721",2018-12-25 10:20:18,26.4,50,110340,0
"8711",2018-12-25 10:21:37,26.4,4500,114840,0.16
"870",2018-12-25 10:21:56,26.4,1700,116540,0.06
"869",2018-12-25 10:22:00,26.4,800,117340,0.03
"868",2018-12-25 10:22:08,26.4,1050,118390,0.04
"867",2018-12-25 10:22:15,26.4,2370,120760,0.08
"866",2018-12-25 10:22:18,26.4,150,120910,0.01
"8651",2018-12-25 10:22:22,26.4,40,120950,0
"8641",2018-12-25 10:22:37,26.35,10000,130950,0.36
"8631",2018-12-25 10:22:38,26.4,20,130970,0
"8621",2018-12-25 10:23:00,26.35,100,131070,0
"8611",2018-12-25 10:23:01,26.4,3000,134070,0.11
"860",2018-12-25 10:23:15,26.4,2370,136440,0.08
"859",2018-12-25 10:23:17,26.35,3930,140370,0.14
"858",2018-12-25 10:23:33,26.35,1000,141370,0.04
"857",2018-12-25 10:23:40,26.35,70,141440,0
"856",2018-12-25 10:24:14,26.35,6030,147470,0.22
"8551",2018-12-25 10:24:22,26.35,10,147480,0
"8541",2018-12-25 10:24:25,26.35,2370,149850,0.08
"8531",2018-12-25 10:24:32,26.35,100,149950,0
"8521",2018-12-25 10:24:34,26.35,500,150450,0.02
"8511",2018-12-25 10:24:36,26.35,50,150500,0
"850",2018-12-25 10:25:01,26.35,100,150600,0
"849",2018-12-25 10:25:02,26.35,1640,152240,0.06
"848",2018-12-25 10:25:07,26.4,70,152310,0
"847",2018-12-25 10:25:42,26.35,1300,153610,0.05
"846",2018-12-25 10:25:53,26.35,1000,154610,0.04
"8451",2018-12-25 10:26:14,26.35,5000,159610,0.18
"8441",2018-12-25 10:26:28,26.35,6700,166310,0.24
"8431",2018-12-25 10:26:39,26.35,400,166710,0.01
"8421",2018-12-25 10:27:33,26.35,7320,174030,0.26
"8411",2018-12-25 10:27:35,26.35,90,174120,0
"840",2018-12-25 10:27:38,26.3,21380,195500,0.76
"839",2018-12-25 10:28:01,26.35,800,196300,0.03
"838",2018-12-25 10:28:13,26.3,2000,198300,0.07
"837",2018-12-25 10:28:22,26.3,5490,203790,0.2
"836",2018-12-25 10:28:42,26.3,100,203890,0
"8351",2018-12-25 10:28:50,26.3,300,204190,0.01
"8341",2018-12-25 10:29:00,26.3,500,204690,0.02
"8331",2018-12-25 10:29:14,26.3,5000,209690,0.18
"8321",2018-12-25 10:29:18,26.3,100,209790,0
"8311",2018-12-25 10:29:19,26.25,20,209810,0
"830",2018-12-25 10:29:39,26.3,100,209910,0
"829",2018-12-25 10:29:56,26.3,2000,211910,0.07
"828",2018-12-25 10:29:59,26.3,1000,212910,0.04
"827",2018-12-25 10:30:07,26.3,3560,216470,0.13
"826",2018-12-25 10:30:14,26.3,400,216870,0.01
"8251",2018-12-25 10:30:31,26.3,2000,218870,0.07
"8241",2018-12-25 10:30:37,26.3,500,219370,0.02
"8231",2018-12-25 10:30:44,26.3,2000,221370,0.07
"8221",2018-12-25 10:30:45,26.3,30,221400,0
"8211",2018-12-25 10:30:52,26.3,50,221450,0
"820",2018-12-25 10:31:30,26.3,1000,222450,0.04
"8191",2018-12-25 10:31:33,26.25,300,222750,0.01
"8181",2018-12-25 10:32:17,26.3,50,222800,0
"8171",2018-12-25 10:32:25,26.3,700,223500,0.02
"8161",2018-12-25 10:32:37,26.3,50,223550,0
"8151",2018-12-25 10:32:39,26.3,10,223560,0
"8141",2018-12-25 10:32:55,26.25,1000,224560,0.04
"8131",2018-12-25 10:33:19,26.3,20,224580,0
"8121",2018-12-25 10:33:42,26.3,30,224610,0
"8111",2018-12-25 10:33:47,26.3,2000,226610,0.07
"8101",2018-12-25 10:33:54,26.3,1500,228110,0.05
"809",2018-12-25 10:33:56,26.3,1000,229110,0.04
"808",2018-12-25 10:33:58,26.3,20,229130,0
"807",2018-12-25 10:34:00,26.3,1000,230130,0.04
"806",2018-12-25 10:34:21,26.3,3560,233690,0.13
"8051",2018-12-25 10:34:29,26.3,20,233710,0
"8041",2018-12-25 10:34:36,26.25,1500,235210,0.05
"8031",2018-12-25 10:34:50,26.3,500,235710,0.02
"8021",2018-12-25 10:35:09,26.3,10,235720,0
"8011",2018-12-25 10:35:15,26.25,25820,261540,0.92
"800",2018-12-25 10:35:18,26.2,500,262040,0.02
"799",2018-12-25 10:35:46,26.25,2000,264040,0.07
"798",2018-12-25 10:35:47,26.25,100,264140,0
"797",2018-12-25 10:35:54,26.2,500,264640,0.02
"796",2018-12-25 10:36:10,26.2,130,264770,0
"7951",2018-12-25 10:36:11,26.2,2000,266770,0.07
"7941",2018-12-25 10:36:19,26.25,9000,275770,0.32
"7931",2018-12-25 10:36:23,26.25,1000,276770,0.04
"7921",2018-12-25 10:36:26,26.25,2080,278850,0.07
"7911",2018-12-25 10:36:44,26.25,1500,280350,0.05
"790",2018-12-25 10:37:08,26.3,460,280810,0.02
"789",2018-12-25 10:37:10,26.3,20,280830,0
"788",2018-12-25 10:37:12,26.25,4000,284830,0.14
"787",2018-12-25 10:37:39,26.25,290,285120,0.01
"786",2018-12-25 10:37:43,26.3,10000,295120,0.36
"7851",2018-12-25 10:38:03,26.3,20,295140,0
"7841",2018-12-25 10:38:34,26.3,3560,298700,0.13
"7831",2018-12-25 10:38:36,26.3,5000,303700,0.18
"7821",2018-12-25 10:38:41,26.3,2000,305700,0.07
"7811",2018-12-25 10:38:49,26.25,1000,306700,0.04
"780",2018-12-25 10:38:55,26.3,20000,326700,0.71
"779",2018-12-25 10:39:05,26.3,1050,327750,0.04
"778",2018-12-25 10:39:16,26.3,20,327770,0
"777",2018-12-25 10:39:17,26.3,30,327800,0
"776",2018-12-25 10:39:21,26.3,2530,330330,0.09
"7751",2018-12-25 10:39:30,26.3,390,330720,0.01
"7741",2018-12-25 10:39:32,26.3,500,331220,0.02
"7731",2018-12-25 10:39:42,26.3,20,331240,0
"7721",2018-12-25 10:39:49,26.3,30,331270,0
"7711",2018-12-25 10:39:59,26.3,100,331370,0
"770",2018-12-25 10:40:13,26.3,10,331380,0
"769",2018-12-25 10:40:17,26.3,500,331880,0.02
"768",2018-12-25 10:40:18,26.3,5000,336880,0.18
"767",2018-12-25 10:40:29,26.3,700,337580,0.02
"766",2018-12-25 10:40:30,26.3,2000,339580,0.07
"7651",2018-12-25 10:40:39,26.3,4240,343820,0.15
"7641",2018-12-25 10:40:59,26.3,9710,353530,0.35
"7631",2018-12-25 10:41:04,26.3,100,353630,0
"7621",2018-12-25 10:41:13,26.3,190,353820,0.01
"7611",2018-12-25 10:41:53,26.35,500,354320,0.02
"760",2018-12-25 10:42:19,26.4,1300,355620,0.05
"759",2018-12-25 10:42:25,26.35,200,355820,0.01
"758",2018-12-25 10:42:40,26.4,3000,358820,0.11
"757",2018-12-25 10:42:47,26.4,3560,362380,0.13
"756",2018-12-25 10:42:57,26.4,4000,366380,0.14
"7551",2018-12-25 10:43:02,26.4,100,366480,0
"7541",2018-12-25 10:43:42,26.4,9530,376010,0.34
"7531",2018-12-25 10:44:06,26.4,2000,378010,0.07
"7521",2018-12-25 10:44:26,26.4,240,378250,0.01
"7511",2018-12-25 10:44:33,26.4,1860,380110,0.07
"750",2018-12-25 10:45:06,26.45,2000,382110,0.07
"749",2018-12-25 10:45:54,26.45,50,382160,0
"748",2018-12-25 10:46:03,26.45,2000,384160,0.07
"747",2018-12-25 10:46:11,26.45,150,384310,0.01
"746",2018-12-25 10:46:46,26.45,1000,385310,0.04
"7451",2018-12-25 10:46:50,26.45,500,385810,0.02
"7441",2018-12-25 10:46:53,26.45,1000,386810,0.04
"7431",2018-12-25 10:47:00,26.45,30,386840,0
"7421",2018-12-25 10:47:01,26.45,3560,390400,0.13
"7411",2018-12-25 10:47:16,26.45,2000,392400,0.07
"740",2018-12-25 10:47:25,26.45,30,392430,0
"739",2018-12-25 10:47:33,26.45,10,392440,0
"738",2018-12-25 10:48:40,26.45,600,393040,0.02
"737",2018-12-25 10:48:58,26.45,50,393090,0
"736",2018-12-25 10:48:59,26.45,30,393120,0
"7351",2018-12-25 10:49:07,26.45,3560,396680,0.13
"7341",2018-12-25 10:49:12,26.45,50,396730,0
"7331",2018-12-25 10:49:25,26.45,1000,397730,0.04
"7321",2018-12-25 10:49:34,26.45,10000,407730,0.36
"7311",2018-12-25 10:49:36,26.45,1000,408730,0.04
"730",2018-12-25 10:50:49,26.45,5000,413730,0.18
"729",2018-12-25 10:50:54,26.4,10,413740,0
"728",2018-12-25 10:51:12,26.45,2500,416240,0.09
"727",2018-12-25 10:51:14,26.45,3560,419800,0.13
"726",2018-12-25 10:51:53,26.45,60,419860,0
"7251",2018-12-25 10:52:31,26.45,10000,429860,0.36
"7241",2018-12-25 10:52:40,26.45,6600,436460,0.24
"7231",2018-12-25 10:52:47,26.45,740,437200,0.03
"7221",2018-12-25 10:52:49,26.45,1300,438500,0.05
"7211",2018-12-25 10:53:21,26.45,4060,442560,0.14
"720",2018-12-25 10:53:22,26.45,1000,443560,0.04
"7191",2018-12-25 10:53:39,26.45,200,443760,0.01
"7181",2018-12-25 10:53:40,26.45,1150,444910,0.04
"7171",2018-12-25 10:54:18,26.45,1020,445930,0.04
"7161",2018-12-25 10:54:29,26.45,10,445940,0
"7151",2018-12-25 10:55:05,26.45,90,446030,0
"7141",2018-12-25 10:55:20,26.4,20,446050,0
"7131",2018-12-25 10:55:30,26.45,50,446100,0
"7121",2018-12-25 10:55:57,26.45,5000,451100,0.18
"7111",2018-12-25 10:56:04,26.45,1000,452100,0.04
"7101",2018-12-25 10:56:27,26.45,2000,454100,0.07
"709",2018-12-25 10:56:45,26.4,30000,484100,1.07
"708",2018-12-25 10:56:52,26.4,18000,502100,0.64
"707",2018-12-25 10:57:02,26.4,7000,509100,0.25
"706",2018-12-25 10:57:36,26.4,500,509600,0.02
"7051",2018-12-25 10:57:58,26.4,100,509700,0
"7041",2018-12-25 10:58:06,26.45,10,509710,0
"7031",2018-12-25 10:58:32,26.4,100,509810,0
"7021",2018-12-25 10:58:33,26.45,200,510010,0.01
"7011",2018-12-25 10:58:53,26.45,1000,511010,0.04
"700",2018-12-25 10:59:41,26.45,3560,514570,0.13
"699",2018-12-25 10:59:43,26.4,5000,519570,0.18
"698",2018-12-25 10:59:59,26.4,300,519870,0.01
"697",2018-12-25 11:00:23,26.4,10000,529870,0.36
"696",2018-12-25 11:00:36,26.4,300,530170,0.01
"6951",2018-12-25 11:00:39,26.45,50,530220,0
"6941",2018-12-25 11:00:41,26.4,9340,539560,0.33
"6931",2018-12-25 11:01:25,26.4,6000,545560,0.21
"6921",2018-12-25 11:01:44,26.4,1000,546560,0.04
"6911",2018-12-25 11:01:48,26.4,3560,550120,0.13
"690",2018-12-25 11:02:04,26.4,1000,551120,0.04
"689",2018-12-25 11:02:09,26.4,1500,552620,0.05
"688",2018-12-25 11:02:14,26.4,1000,553620,0.04
"687",2018-12-25 11:02:39,26.4,800,554420,0.03
"686",2018-12-25 11:03:01,26.4,10,554430,0
"6851",2018-12-25 11:03:18,26.4,1000,555430,0.04
"6841",2018-12-25 11:03:22,26.4,150,555580,0.01
"6831",2018-12-25 11:03:26,26.4,4500,560080,0.16
"6821",2018-12-25 11:03:27,26.4,100,560180,0
"6811",2018-12-25 11:03:35,26.4,1260,561440,0.04
"680",2018-12-25 11:03:51,26.4,10,561450,0
"679",2018-12-25 11:04:38,26.4,8010,569460,0.29
"678",2018-12-25 11:05:20,26.45,5000,574460,0.18
"677",2018-12-25 11:06:01,26.45,3560,578020,0.13
"676",2018-12-25 11:06:19,26.45,1000,579020,0.04
"6751",2018-12-25 11:06:21,26.4,770,579790,0.03
"6741",2018-12-25 11:06:28,26.45,5000,584790,0.18
"6731",2018-12-25 11:06:37,26.4,14000,598790,0.5
"6721",2018-12-25 11:07:08,26.4,6590,605380,0.24
"6711",2018-12-25 11:07:24,26.4,1000,606380,0.04
"670",2018-12-25 11:07:33,26.35,10,606390,0
"669",2018-12-25 11:08:01,26.4,260,606650,0.01
"668",2018-12-25 11:08:07,26.4,3560,610210,0.13
"667",2018-12-25 11:08:12,26.4,5000,615210,0.18
"666",2018-12-25 11:08:13,26.35,30000,645210,1.07
"6651",2018-12-25 11:08:14,26.4,100,645310,0
"6641",2018-12-25 11:08:48,26.35,6490,651800,0.23
"6631",2018-12-25 11:08:49,26.4,1500,653300,0.05
"6621",2018-12-25 11:09:06,26.4,150,653450,0.01
"6611",2018-12-25 11:09:56,26.4,50,653500,0
"660",2018-12-25 11:10:11,26.4,1320,654820,0.05
"659",2018-12-25 11:11:06,26.45,4300,659120,0.15
"658",2018-12-25 11:12:06,26.45,4000,663120,0.14
"657",2018-12-25 11:12:21,26.45,3560,666680,0.13
"656",2018-12-25 11:13:23,26.4,500,667180,0.02
"6551",2018-12-25 11:13:26,26.4,100,667280,0
"6541",2018-12-25 11:13:44,26.4,130,667410,0
"6531",2018-12-25 11:14:38,26.4,10,667420,0
"6521",2018-12-25 11:14:51,26.45,100,667520,0
"6511",2018-12-25 11:14:52,26.4,1000,668520,0.04
"650",2018-12-25 11:15:18,26.3,86090,754610,3.07
"649",2018-12-25 11:16:18,26.4,5000,759610,0.18
"648",2018-12-25 11:16:24,26.4,1000,760610,0.04
"647",2018-12-25 11:16:35,26.4,27570,788180,0.98
"646",2018-12-25 11:17:33,26.35,550,788730,0.02
"6451",2018-12-25 11:17:48,26.3,10,788740,0
"6441",2018-12-25 11:19:11,26.35,3450,792190,0.12
"6431",2018-12-25 11:19:15,26.35,620,792810,0.02
"6421",2018-12-25 11:19:18,26.35,100,792910,0
"6411",2018-12-25 11:19:20,26.35,500,793410,0.02
"640",2018-12-25 11:19:53,26.3,540,793950,0.02
"639",2018-12-25 11:21:01,26.3,22430,816380,0.8
"638",2018-12-25 11:21:04,26.3,6000,822380,0.21
"637",2018-12-25 11:21:12,26.3,10000,832380,0.36
"636",2018-12-25 11:21:16,26.3,14000,846380,0.5
"6351",2018-12-25 11:21:18,26.3,10000,856380,0.36
"6341",2018-12-25 11:21:30,26.3,230,856610,0.01
"6331",2018-12-25 11:21:32,26.3,500,857110,0.02
"6321",2018-12-25 11:21:44,26.35,2370,859480,0.08
"6311",2018-12-25 11:21:47,26.3,500,859980,0.02
"630",2018-12-25 11:22:28,26.35,2370,862350,0.08
"629",2018-12-25 11:22:44,26.3,1190,863540,0.04
"628",2018-12-25 11:23:02,26.35,50,863590,0
"627",2018-12-25 11:23:09,26.3,200,863790,0.01
"626",2018-12-25 11:23:10,26.3,2370,866160,0.08
"6251",2018-12-25 11:23:21,26.3,3000,869160,0.11
"6241",2018-12-25 11:23:29,26.3,200,869360,0.01
"6231",2018-12-25 11:23:44,26.3,20,869380,0
"6221",2018-12-25 11:24:03,26.3,190,869570,0.01
"6211",2018-12-25 11:24:29,26.25,10,869580,0
"620",2018-12-25 11:25:17,26.3,1000,870580,0.04
"6191",2018-12-25 11:25:18,26.3,100,870680,0
"6181",2018-12-25 11:25:20,26.25,2000,872680,0.07
"6171",2018-12-25 11:25:28,26.3,2920,875600,0.1
"6161",2018-12-25 11:25:46,26.3,400,876000,0.01
"6151",2018-12-25 11:26:42,26.3,190,876190,0.01
"6141",2018-12-25 11:27:32,26.3,2000,878190,0.07
"6131",2018-12-25 11:27:45,26.3,4490,882680,0.16
"6121",2018-12-25 11:28:18,26.3,10,882690,0
"6111",2018-12-25 11:28:20,26.3,500,883190,0.02
"6101",2018-12-25 11:28:24,26.3,5000,888190,0.18
"609",2018-12-25 11:28:29,26.3,2200,890390,0.08
"608",2018-12-25 11:28:33,26.3,2800,893190,0.1
"607",2018-12-25 11:29:13,26.3,10,893200,0
"606",2018-12-25 11:29:50,26.3,450,893650,0.02
"6051",2018-12-25 11:29:53,26.3,3000,896650,0.11
"6041",2018-12-25 11:30:49,26.3,8240,904890,0.29
"6031",2018-12-25 11:31:22,26.3,5000,909890,0.18
"6021",2018-12-25 11:31:54,26.3,5010,914900,0.18
"6011",2018-12-25 11:32:38,26.3,1000,915900,0.04
"600",2018-12-25 11:32:45,26.3,100,916000,0
"599",2018-12-25 11:33:35,26.3,10,916010,0
"598",2018-12-25 11:33:44,26.3,6430,922440,0.23
"597",2018-12-25 11:33:46,26.35,100,922540,0
"596",2018-12-25 11:33:55,26.3,3000,925540,0.11
"5951",2018-12-25 11:34:55,26.3,7010,932550,0.25
"5941",2018-12-25 11:34:57,26.3,300,932850,0.01
"5931",2018-12-25 11:35:49,26.3,100,932950,0
"5921",2018-12-25 11:35:53,26.3,10,932960,0
"5911",2018-12-25 11:36:15,26.3,2370,935330,0.08
"590",2018-12-25 11:36:16,26.3,1500,936830,0.05
"589",2018-12-25 11:36:57,26.25,3000,939830,0.11
"588",2018-12-25 11:37:05,26.25,5000,944830,0.18
"587",2018-12-25 11:37:13,26.25,140,944970,0
"586",2018-12-25 11:37:24,26.25,2000,946970,0.07
"5851",2018-12-25 11:37:33,26.25,10000,956970,0.36
"5841",2018-12-25 11:37:39,26.25,180,957150,0.01
"5831",2018-12-25 11:37:40,26.3,1000,958150,0.04
"5821",2018-12-25 11:37:49,26.25,17550,975700,0.63
"5811",2018-12-25 11:37:55,26.25,1030,976730,0.04
"580",2018-12-25 11:38:13,26.2,30000,1006730,1.07
"579",2018-12-25 11:38:21,26.25,10,1006740,0
"578",2018-12-25 11:38:23,26.2,9000,1015740,0.32
"577",2018-12-25 11:38:28,26.2,7000,1022740,0.25
"576",2018-12-25 11:38:29,26.1,50000,1072740,1.78
"5751",2018-12-25 11:38:50,26.1,20000,1092740,0.71
"5741",2018-12-25 11:38:53,26.1,1000,1093740,0.04
"5731",2018-12-25 11:38:54,26.1,590,1094330,0.02
"5721",2018-12-25 11:38:56,26.1,830,1095160,0.03
"5711",2018-12-25 11:38:57,26.05,10,1095170,0
"570",2018-12-25 11:39:04,26.1,100,1095270,0
"569",2018-12-25 11:39:15,26,8810,1104080,0.31
"568",2018-12-25 11:39:22,26,10760,1114840,0.38
"567",2018-12-25 11:39:25,26,20000,1134840,0.71
"566",2018-12-25 11:39:46,26,500,1135340,0.02
"5651",2018-12-25 11:39:53,26,8000,1143340,0.29
"5641",2018-12-25 11:39:55,26,25000,1168340,0.89
"5631",2018-12-25 11:40:04,26,11000,1179340,0.39
"5621",2018-12-25 11:40:05,26,1500,1180840,0.05
"5611",2018-12-25 11:40:09,26,2430,1183270,0.09
"560",2018-12-25 11:40:19,26,5000,1188270,0.18
"559",2018-12-25 11:40:25,26,100,1188370,0
"5581",2018-12-25 11:40:27,26,550,1188920,0.02
"5571",2018-12-25 11:40:37,26,1450,1190370,0.05
"5561",2018-12-25 11:40:56,25.95,10,1190380,0
"5551",2018-12-25 11:41:10,25.95,400,1190780,0.01
"5541",2018-12-25 11:41:15,26,4670,1195450,0.17
"5531",2018-12-25 11:41:22,26,10000,1205450,0.36
"5521",2018-12-25 11:41:34,26,35330,1240780,1.26
"5511",2018-12-25 11:41:51,26,100,1240880,0
"5501",2018-12-25 11:41:55,26,5000,1245880,0.18
"5491",2018-12-25 11:42:03,25.9,15000,1260880,0.54
"5481",2018-12-25 11:42:13,25.9,5000,1265880,0.18
"5471",2018-12-25 11:42:18,25.9,4010,1269890,0.14
"5461",2018-12-25 11:42:34,26,20000,1289890,0.71
"5451",2018-12-25 11:42:39,25.9,2600,1292490,0.09
"5441",2018-12-25 11:42:59,25.9,1300,1293790,0.05
"5431",2018-12-25 11:43:13,25.9,500,1294290,0.02
"5421",2018-12-25 11:43:14,25.9,10000,1304290,0.36
"5413",2018-12-25 11:43:17,25.9,30,1304320,0
"5401",2018-12-25 11:43:20,25.9,100,1304420,0
"5391",2018-12-25 11:43:24,25.9,360,1304780,0.01
"5381",2018-12-25 11:43:32,25.9,30,1304810,0
"5371",2018-12-25 11:43:49,25.9,500,1305310,0.02
"5361",2018-12-25 11:43:54,25.9,1140,1306450,0.04
"5351",2018-12-25 11:43:57,26,2000,1308450,0.07
"5341",2018-12-25 11:44:15,25.9,10,1308460,0
"5331",2018-12-25 11:44:21,26,10160,1318620,0.36
"5321",2018-12-25 11:44:26,25.9,15000,1333620,0.54
"5315",2018-12-25 11:44:38,25.9,1450,1335070,0.05
"5301",2018-12-25 11:44:41,25.9,200,1335270,0.01
"5291",2018-12-25 11:44:47,25.9,2000,1337270,0.07
"5281",2018-12-25 11:44:48,25.9,5000,1342270,0.18
"5271",2018-12-25 11:44:53,25.9,500,1342770,0.02
"5261",2018-12-25 11:44:55,25.9,3550,1346320,0.13
"5251",2018-12-25 11:45:24,26,10,1346330,0
"5241",2018-12-25 11:45:44,25.9,3020,1349350,0.11
"5231",2018-12-25 11:46:41,25.9,500,1349850,0.02
"5221",2018-12-25 11:47:45,25.9,5000,1354850,0.18
"5215",2018-12-25 11:48:18,25.9,10000,1364850,0.36
"5201",2018-12-25 11:48:34,25.9,1000,1365850,0.04
"5191",2018-12-25 11:48:38,25.9,3620,1369470,0.13
"5181",2018-12-25 11:48:44,25.9,120,1369590,0
"5171",2018-12-25 11:48:45,25.9,2370,1371960,0.08
"5161",2018-12-25 11:49:54,25.9,50,1372010,0
"5151",2018-12-25 11:50:04,25.85,3000,1375010,0.11
"5141",2018-12-25 11:50:18,25.9,2370,1377380,0.08
"5131",2018-12-25 11:50:58,25.85,10,1377390,0
"5121",2018-12-25 11:50:59,25.9,26470,1403860,0.94
"5115",2018-12-25 11:51:00,25.9,700,1404560,0.02
"5101",2018-12-25 11:51:01,25.8,10000,1414560,0.36
"5091",2018-12-25 11:51:23,25.8,20000,1434560,0.71
"5081",2018-12-25 11:52:48,25.95,2370,1436930,0.08
"5071",2018-12-25 11:53:03,25.9,30,1436960,0
"5061",2018-12-25 11:53:19,25.9,9970,1446930,0.36
"5051",2018-12-25 11:53:27,25.9,5000,1451930,0.18
"5041",2018-12-25 11:53:30,25.9,50,1451980,0
"5031",2018-12-25 11:53:34,25.9,4980,1456960,0.18
"5021",2018-12-25 11:53:40,25.9,1000,1457960,0.04
"5015",2018-12-25 11:53:46,25.9,500,1458460,0.02
"5001",2018-12-25 11:53:53,25.9,20,1458480,0
"4991",2018-12-25 11:54:02,25.9,650,1459130,0.02
"4981",2018-12-25 11:54:07,25.95,1000,1460130,0.04
"4971",2018-12-25 11:54:15,25.8,36000,1496130,1.28
"4961",2018-12-25 11:54:33,25.95,10,1496140,0
"4951",2018-12-25 11:55:19,25.95,500,1496640,0.02
"4942",2018-12-25 11:55:51,25.95,20,1496660,0
"4932",2018-12-25 11:56:07,25.95,220,1496880,0.01
"4922",2018-12-25 11:56:15,25.9,10,1496890,0
"4916",2018-12-25 11:56:42,25.95,400,1497290,0.01
"4902",2018-12-25 11:57:15,25.95,1300,1498590,0.05
"4892",2018-12-25 11:57:24,25.95,20,1498610,0
"4882",2018-12-25 11:57:39,25.95,10,1498620,0
"4872",2018-12-25 11:57:54,25.95,260,1498880,0.01
"4862",2018-12-25 11:57:59,25.95,1000,1499880,0.04
"4852",2018-12-25 11:58:04,25.95,2000,1501880,0.07
"4842",2018-12-25 11:59:14,25.95,460,1502340,0.02
"4832",2018-12-25 11:59:20,25.95,50,1502390,0
"4822",2018-12-25 12:00:07,25.95,10,1502400,0
"4816",2018-12-25 12:00:22,25.95,100,1502500,0
"4802",2018-12-25 12:00:27,25.95,750,1503250,0.03
"4792",2018-12-25 12:00:29,25.95,1090,1504340,0.04
"4782",2018-12-25 12:00:36,25.95,70,1504410,0
"4772",2018-12-25 12:00:49,25.95,400,1504810,0.01
"4762",2018-12-25 12:01:17,26,30,1504840,0
"4752",2018-12-25 12:01:40,26,1500,1506340,0.05
"4742",2018-12-25 12:02:39,26,2370,1508710,0.08
"4732",2018-12-25 12:02:45,26,500,1509210,0.02
"4722",2018-12-25 12:03:03,26,1000,1510210,0.04
"4716",2018-12-25 12:03:26,26,200,1510410,0.01
"4702",2018-12-25 12:03:33,26,6870,1517280,0.25
"4692",2018-12-25 12:03:40,26,6000,1523280,0.21
"4682",2018-12-25 12:03:47,26,100,1523380,0
"4672",2018-12-25 12:03:57,26,1000,1524380,0.04
"4662",2018-12-25 12:04:09,26,3000,1527380,0.11
"4652",2018-12-25 12:04:21,26,500,1527880,0.02
"4642",2018-12-25 12:04:35,26,10000,1537880,0.36
"4632",2018-12-25 12:04:36,26,2000,1539880,0.07
"4622",2018-12-25 12:04:37,26,39450,1579330,1.41
"4616",2018-12-25 12:05:45,26,330,1579660,0.01
"4602",2018-12-25 12:05:59,26,200,1579860,0.01
"4592",2018-12-25 12:06:37,26,26410,1606270,0.94
"4582",2018-12-25 12:06:54,26,1890,1608160,0.07
"4572",2018-12-25 12:06:56,26,30,1608190,0
"4562",2018-12-25 12:06:58,26,1000,1609190,0.04
"4552",2018-12-25 12:07:24,26,2590,1611780,0.09
"4542",2018-12-25 12:08:50,26,2000,1613780,0.07
"4532",2018-12-25 12:09:24,26,5000,1618780,0.18
"4522",2018-12-25 12:09:42,26,250,1619030,0.01
"4516",2018-12-25 12:09:55,26,2000,1621030,0.07
"4502",2018-12-25 12:09:57,26,60,1621090,0
"4492",2018-12-25 12:10:09,26,750,1621840,0.03
"4482",2018-12-25 12:10:18,26,3000,1624840,0.11
"4472",2018-12-25 12:10:37,26,1000,1625840,0.04
"4462",2018-12-25 12:10:53,26,200,1626040,0.01
"4452",2018-12-25 12:11:02,26,100,1626140,0
"4442",2018-12-25 12:11:16,26,27130,1653270,0.97
"4432",2018-12-25 12:11:17,26,300,1653570,0.01
"4422",2018-12-25 12:12:14,26,1000,1654570,0.04
"4416",2018-12-25 12:13:12,26,6000,1660570,0.21
"4402",2018-12-25 12:14:02,26,300,1660870,0.01
"4392",2018-12-25 12:14:04,26.1,22510,1683380,0.8
"4382",2018-12-25 12:14:15,26.1,500,1683880,0.02
"4372",2018-12-25 12:14:26,26.1,100,1683980,0
"4362",2018-12-25 12:14:41,26.1,700,1684680,0.02
"4352",2018-12-25 12:15:05,26.2,800,1685480,0.03
"4342",2018-12-25 12:15:33,26.2,190,1685670,0.01
"4332",2018-12-25 12:15:36,26.2,10,1685680,0
"4322",2018-12-25 12:15:43,26.2,100,1685780,0
"4316",2018-12-25 12:16:25,26.2,3000,1688780,0.11
"4302",2018-12-25 12:16:36,26.1,10,1688790,0
"4292",2018-12-25 12:17:30,26.1,28190,1716980,1.01
"4282",2018-12-25 12:17:49,26.1,3000,1719980,0.11
"4272",2018-12-25 12:18:07,26.05,10,1719990,0
"4262",2018-12-25 12:18:13,26.1,60,1720050,0
"4252",2018-12-25 12:19:12,26.1,3000,1723050,0.11
"4242",2018-12-25 12:20:01,26.1,140,1723190,0
"4232",2018-12-25 12:20:05,26.1,600,1723790,0.02
"4222",2018-12-25 12:20:09,26.05,200,1723990,0.01
"4216",2018-12-25 12:20:13,26.1,2000,1725990,0.07
"4202",2018-12-25 12:20:36,26.1,3000,1728990,0.11
"4192",2018-12-25 12:20:44,26,25000,1753990,0.89
"4182",2018-12-25 12:20:59,26,2580,1756570,0.09
"4172",2018-12-25 12:21:05,26,140,1756710,0
"4162",2018-12-25 12:21:40,25.95,250,1756960,0.01
"4152",2018-12-25 12:21:44,26,500,1757460,0.02
"4142",2018-12-25 12:21:50,26,20,1757480,0
"4132",2018-12-25 12:22:00,26,3000,1760480,0.11
"4122",2018-12-25 12:22:09,26,140,1760620,0
"4116",2018-12-25 12:22:43,25.95,10000,1770620,0.36
"4106",2018-12-25 12:23:13,26,140,1770760,0
"4092",2018-12-25 12:23:24,26,3000,1773760,0.11
"4082",2018-12-25 12:23:39,26,20,1773780,0
"4072",2018-12-25 12:24:17,26,140,1773920,0
"4062",2018-12-25 12:24:48,26,3000,1776920,0.11
"4052",2018-12-25 12:25:17,26,1000,1777920,0.04
"4042",2018-12-25 12:25:21,26,140,1778060,0
"4032",2018-12-25 12:25:28,26,2370,1780430,0.08
"4022",2018-12-25 12:25:32,26,20,1780450,0
"4016",2018-12-25 12:25:36,26,5310,1785760,0.19
"4002",2018-12-25 12:26:05,26,2370,1788130,0.08
"3992",2018-12-25 12:26:12,26,2260,1790390,0.08
"3982",2018-12-25 12:26:19,26,630,1791020,0.02
"3972",2018-12-25 12:26:25,26.1,140,1791160,0
"3962",2018-12-25 12:27:35,26.1,3140,1794300,0.11
"3952",2018-12-25 12:27:44,25.95,15000,1809300,0.54
"3942",2018-12-25 12:28:33,26.1,140,1809440,0
"3932",2018-12-25 12:28:34,26.1,200,1809640,0.01
"3922",2018-12-25 12:28:59,26.1,3000,1812640,0.11
"3916",2018-12-25 12:29:37,26.1,140,1812780,0
"3902",2018-12-25 14:01:11,26.1,22400,1835180,0.8
"3892",2018-12-25 14:01:15,26.15,140,1835320,0
"3882",2018-12-25 14:01:47,26.15,3140,1838460,0.11
"3872",2018-12-25 14:02:13,26.1,4000,1842460,0.14
"3862",2018-12-25 14:02:48,26.15,140,1842600,0
"3852",2018-12-25 14:03:11,26.15,3000,1845600,0.11
"3842",2018-12-25 14:03:15,26.15,7500,1853100,0.27
"3832",2018-12-25 14:03:19,26.15,17880,1870980,0.64
"3823",2018-12-25 14:03:52,26.2,140,1871120,0
"3817",2018-12-25 14:04:18,26.15,10,1871130,0
"3803",2018-12-25 14:04:56,26.2,140,1871270,0
"3793",2018-12-25 14:05:52,26.15,12000,1883270,0.43
"3783",2018-12-25 14:06:00,26.2,140,1883410,0
"3774",2018-12-25 14:06:25,26.15,6910,1890320,0.25
"3764",2018-12-25 14:06:37,26.15,20,1890340,0
"3754",2018-12-25 14:06:43,26.15,1070,1891410,0.04
"3744",2018-12-25 14:07:04,26.2,140,1891550,0
"3734",2018-12-25 14:07:14,26.15,1230,1892780,0.04
"3724",2018-12-25 14:07:25,26.2,10000,1902780,0.36
"3718",2018-12-25 14:07:26,26.15,1100,1903880,0.04
"3704",2018-12-25 14:07:27,26.2,10000,1913880,0.36
"3694",2018-12-25 14:07:44,26.2,10140,1924020,0.36
"3684",2018-12-25 14:07:48,26.2,12500,1936520,0.45
"3674",2018-12-25 14:07:57,26.2,1000,1937520,0.04
"3664",2018-12-25 14:08:08,26.2,140,1937660,0
"3654",2018-12-25 14:08:14,26.2,7000,1944660,0.25
"3644",2018-12-25 14:08:15,26.2,300,1944960,0.01
"3634",2018-12-25 14:08:17,26.2,2470,1947430,0.09
"3624",2018-12-25 14:08:36,26.25,1000,1948430,0.04
"3618",2018-12-25 14:08:38,26.25,2000,1950430,0.07
"3604",2018-12-25 14:08:46,26.25,3000,1953430,0.11
"3594",2018-12-25 14:08:58,26.25,5000,1958430,0.18
"3584",2018-12-25 14:08:59,26.25,1000,1959430,0.04
"3574",2018-12-25 14:09:02,26.25,960,1960390,0.03
"3564",2018-12-25 14:09:12,26.25,150,1960540,0.01
"3554",2018-12-25 14:10:16,26.3,540,1961080,0.02
"3544",2018-12-25 14:10:22,26.3,5000,1966080,0.18
"3534",2018-12-25 14:10:25,26.3,10000,1976080,0.36
"3524",2018-12-25 14:10:28,26.3,360,1976440,0.01
"3518",2018-12-25 14:10:36,26.3,10,1976450,0
"3504",2018-12-25 14:10:53,26.25,5000,1981450,0.18
"3495",2018-12-25 14:11:20,26.3,290,1981740,0.01
"3485",2018-12-25 14:11:21,26.3,1000,1982740,0.04
"3475",2018-12-25 14:11:27,26.3,3000,1985740,0.11
"3465",2018-12-25 14:11:32,26.3,20,1985760,0
"3455",2018-12-25 14:11:34,26.3,50,1985810,0
"3445",2018-12-25 14:11:36,26.35,1000,1986810,0.04
"3435",2018-12-25 14:12:24,26.35,140,1986950,0
"3425",2018-12-25 14:12:35,26.35,1000,1987950,0.04
"3419",2018-12-25 14:12:58,26.35,3000,1990950,0.11
"3405",2018-12-25 14:13:28,26.35,140,1991090,0
"3395",2018-12-25 14:14:20,26.3,500,1991590,0.02
"3385",2018-12-25 14:14:32,26.35,140,1991730,0
"3375",2018-12-25 14:14:53,26.35,10,1991740,0
"3365",2018-12-25 14:14:56,26.35,500,1992240,0.02
"3355",2018-12-25 14:15:55,26.35,140,1992380,0
"3345",2018-12-25 14:15:57,26.35,3000,1995380,0.11
"3335",2018-12-25 14:16:10,26.35,3030,1998410,0.11
"3325",2018-12-25 14:16:40,26.35,140,1998550,0
"3319",2018-12-25 14:17:09,26.35,3000,2001550,0.11
"3305",2018-12-25 14:17:33,26.35,30,2001580,0
"3295",2018-12-25 14:17:44,26.35,140,2001720,0
"3285",2018-12-25 14:18:33,26.35,3000,2004720,0.11
"3275",2018-12-25 14:18:38,26.35,5000,2009720,0.18
"3265",2018-12-25 14:18:45,26.35,1000,2010720,0.04
"3255",2018-12-25 14:18:48,26.35,140,2010860,0
"3245",2018-12-25 14:19:01,26.35,5000,2015860,0.18
"3235",2018-12-25 14:19:14,26.35,10,2015870,0
"3225",2018-12-25 14:19:22,26.35,570,2016440,0.02
"3219",2018-12-25 14:19:23,26.35,470,2016910,0.02
"3205",2018-12-25 14:19:24,26.35,530,2017440,0.02
"3195",2018-12-25 14:19:52,26.35,140,2017580,0
"3185",2018-12-25 14:19:54,26.35,10,2017590,0
"3175",2018-12-25 14:19:57,26.35,3000,2020590,0.11
"3165",2018-12-25 14:20:42,26.35,200,2020790,0.01
"3155",2018-12-25 14:20:56,26.35,140,2020930,0
"3145",2018-12-25 14:21:04,26.35,150,2021080,0.01
"3135",2018-12-25 14:21:21,26.35,3000,2024080,0.11
"3125",2018-12-25 14:21:50,26.35,200,2024280,0.01
"3119",2018-12-25 14:21:52,26.35,13130,2037410,0.47
"3109",2018-12-25 14:22:00,26.4,140,2037550,0
"3095",2018-12-25 14:22:39,26.4,720,2038270,0.03
"3085",2018-12-25 14:22:44,26.4,4000,2042270,0.14
"3075",2018-12-25 14:22:45,26.35,10,2042280,0
"3065",2018-12-25 14:23:04,26.4,140,2042420,0
"3056",2018-12-25 14:23:08,26.35,100,2042520,0
"3046",2018-12-25 14:23:21,26.4,50,2042570,0
"3036",2018-12-25 14:23:47,26.35,570,2043140,0.02
"3026",2018-12-25 14:24:08,26.4,140,2043280,0
"30110",2018-12-25 14:24:42,26.35,1050,2044330,0.04
"3006",2018-12-25 14:24:59,26.35,9780,2054110,0.35
"2996",2018-12-25 14:25:12,26.35,140,2054250,0
"2986",2018-12-25 14:25:25,26.35,10,2054260,0
"2976",2018-12-25 14:25:26,26.35,6000,2060260,0.21
"2966",2018-12-25 14:25:32,26.35,2990,2063250,0.11
"2956",2018-12-25 14:25:59,26.35,600,2063850,0.02
"2946",2018-12-25 14:26:04,26.3,8000,2071850,0.29
"2936",2018-12-25 14:26:06,26.35,5000,2076850,0.18
"2926",2018-12-25 14:26:08,26.35,890,2077740,0.03
"29110",2018-12-25 14:26:11,26.35,1110,2078850,0.04
"2906",2018-12-25 14:26:15,26.35,140,2078990,0
"2896",2018-12-25 14:26:22,26.35,2000,2080990,0.07
"2886",2018-12-25 14:26:25,26.35,5000,2085990,0.18
"2876",2018-12-25 14:26:37,26.3,120,2086110,0
"2866",2018-12-25 14:27:19,26.35,130,2086240,0
"2856",2018-12-25 14:28:21,26.35,2990,2089230,0.11
"2846",2018-12-25 14:28:25,26.35,130,2089360,0
"2836",2018-12-25 14:28:55,26.35,1000,2090360,0.04
"2826",2018-12-25 14:29:29,26.35,130,2090490,0
"28110",2018-12-25 14:29:30,26.3,10,2090500,0
"2806",2018-12-25 14:29:57,26.35,1000,2091500,0.04
"2796",2018-12-25 14:30:04,26.35,350,2091850,0.01
"2786",2018-12-25 14:30:32,26.35,130,2091980,0
"2776",2018-12-25 14:30:41,26.35,300,2092280,0.01
"2766",2018-12-25 14:30:46,26.35,3000,2095280,0.11
"2756",2018-12-25 14:30:49,26.35,3750,2099030,0.13
"2746",2018-12-25 14:31:05,26.35,1000,2100030,0.04
"2736",2018-12-25 14:31:07,26.35,2990,2103020,0.11
"2726",2018-12-25 14:31:22,26.35,20,2103040,0
"27110",2018-12-25 14:31:37,26.35,230,2103270,0.01
"2706",2018-12-25 14:31:57,26.35,3180,2106450,0.11
"2696",2018-12-25 14:32:06,26.35,6790,2113240,0.24
"2686",2018-12-25 14:32:16,26.35,10,2113250,0
"2676",2018-12-25 14:32:18,26.35,400,2113650,0.01
"2666",2018-12-25 14:32:32,26.35,2990,2116640,0.11
"2656",2018-12-25 14:32:33,26.35,1000,2117640,0.04
"2646",2018-12-25 14:32:39,26.35,130,2117770,0
"2636",2018-12-25 14:33:23,26.35,150,2117920,0.01
"2626",2018-12-25 14:33:43,26.35,130,2118050,0
"26110",2018-12-25 14:33:55,26.35,2990,2121040,0.11
"2606",2018-12-25 14:33:58,26.35,200,2121240,0.01
"2596",2018-12-25 14:34:11,26.35,60,2121300,0
"2586",2018-12-25 14:34:20,26.35,3500,2124800,0.12
"2576",2018-12-25 14:34:29,26.35,1000,2125800,0.04
"2566",2018-12-25 14:34:30,26.35,180,2125980,0.01
"2556",2018-12-25 14:34:47,26.35,180,2126160,0.01
"2546",2018-12-25 14:34:51,26.35,1000,2127160,0.04
"2536",2018-12-25 14:35:07,26.35,1040,2128200,0.04
"2526",2018-12-25 14:35:09,26.35,1000,2129200,0.04
"25110",2018-12-25 14:35:19,26.35,3130,2132330,0.11
"2506",2018-12-25 14:35:51,26.35,130,2132460,0
"2496",2018-12-25 14:35:52,26.35,500,2132960,0.02
"2486",2018-12-25 14:35:53,26.35,200,2133160,0.01
"2476",2018-12-25 14:35:55,26.35,10000,2143160,0.36
"2466",2018-12-25 14:36:08,26.35,40,2143200,0
"2456",2018-12-25 14:36:12,26.35,100,2143300,0
"2446",2018-12-25 14:36:14,26.35,1070,2144370,0.04
"2436",2018-12-25 14:36:27,26.35,1030,2145400,0.04
"2426",2018-12-25 14:36:55,26.4,130,2145530,0
"24110",2018-12-25 14:37:02,26.4,70,2145600,0
"2406",2018-12-25 14:37:22,26.4,120,2145720,0
"2396",2018-12-25 14:37:45,26.4,100,2145820,0
"2386",2018-12-25 14:37:48,26.4,500,2146320,0.02
"2376",2018-12-25 14:37:58,26.4,300,2146620,0.01
"2366",2018-12-25 14:37:59,26.4,180,2146800,0.01
"2356",2018-12-25 14:38:07,26.4,1730,2148530,0.06
"2346",2018-12-25 14:38:23,26.45,79850,2228380,2.85
"2336",2018-12-25 14:38:52,26.5,5000,2233380,0.18
"2326",2018-12-25 14:38:56,26.5,350,2233730,0.01
"23110",2018-12-25 14:39:03,26.5,130,2233860,0
"2306",2018-12-25 14:39:30,26.5,3130,2236990,0.11
"2296",2018-12-25 14:39:42,26.5,500,2237490,0.02
"2286",2018-12-25 14:39:53,26.45,3000,2240490,0.11
"2276",2018-12-25 14:40:07,26.5,130,2240620,0
"2266",2018-12-25 14:40:13,26.45,50,2240670,0
"2256",2018-12-25 14:41:11,26.5,130,2240800,0
"2246",2018-12-25 14:41:30,26.5,4200,2245000,0.15
"2236",2018-12-25 14:41:37,26.5,370,2245370,0.01
"2226",2018-12-25 14:41:44,26.5,10,2245380,0
"22110",2018-12-25 14:41:55,26.5,1000,2246380,0.04
"2206",2018-12-25 14:42:09,26.5,300,2246680,0.01
"2196",2018-12-25 14:42:11,26.45,1000,2247680,0.04
"2186",2018-12-25 14:42:15,26.5,130,2247810,0
"2176",2018-12-25 14:42:18,26.5,3130,2250940,0.11
"2166",2018-12-25 14:42:23,26.5,20,2250960,0
"2156",2018-12-25 14:42:39,26.5,1000,2251960,0.04
"2146",2018-12-25 14:42:48,26.45,20,2251980,0
"2136",2018-12-25 14:43:19,26.5,130,2252110,0
"2126",2018-12-25 14:43:29,26.5,300,2252410,0.01
"21110",2018-12-25 14:43:42,26.5,3130,2255540,0.11
"21010",2018-12-25 14:43:54,26.5,5000,2260540,0.18
"2096",2018-12-25 14:44:10,26.5,5200,2265740,0.19
"2086",2018-12-25 14:44:23,26.5,130,2265870,0
"2076",2018-12-25 14:44:24,26.5,30,2265900,0
"2066",2018-12-25 14:44:40,26.45,50,2265950,0
"2056",2018-12-25 14:44:57,26.5,1000,2266950,0.04
"2046",2018-12-25 14:45:06,26.5,3130,2270080,0.11
"2036",2018-12-25 14:45:26,26.5,500,2270580,0.02
"2026",2018-12-25 14:45:27,26.5,130,2270710,0
"20110",2018-12-25 14:45:32,26.5,30,2270740,0
"2006",2018-12-25 14:46:18,26.5,410,2271150,0.01
"1996",2018-12-25 14:46:31,26.55,130,2271280,0
"1986",2018-12-25 14:46:37,26.55,200,2271480,0.01
"1976",2018-12-25 14:46:54,26.55,10,2271490,0
"1966",2018-12-25 14:46:57,26.55,200,2271690,0.01
"1956",2018-12-25 14:47:03,26.55,600,2272290,0.02
"1946",2018-12-25 14:47:10,26.5,700,2272990,0.02
"1936",2018-12-25 14:47:19,26.55,10,2273000,0
"1926",2018-12-25 14:47:22,26.55,170,2273170,0.01
"19110",2018-12-25 14:47:35,26.6,9870,2283040,0.35
"1906",2018-12-25 14:47:42,26.55,150,2283190,0.01
"1896",2018-12-25 14:47:51,26.6,5000,2288190,0.18
"1886",2018-12-25 14:47:53,26.6,3230,2291420,0.12
"1876",2018-12-25 14:48:05,26.6,1000,2292420,0.04
"1866",2018-12-25 14:48:17,26.6,4000,2296420,0.14
"1856",2018-12-25 14:48:22,26.6,200,2296620,0.01
"1846",2018-12-25 14:48:39,26.6,130,2296750,0
"1836",2018-12-25 14:49:19,26.6,1000,2297750,0.04
"1826",2018-12-25 14:49:22,26.6,3260,2301010,0.12
"18110",2018-12-25 14:49:25,26.6,2610,2303620,0.09
"1806",2018-12-25 14:49:32,26.6,60,2303680,0
"1796",2018-12-25 14:49:34,26.65,200,2303880,0.01
"1786",2018-12-25 14:49:43,26.7,130,2304010,0
"1776",2018-12-25 14:50:03,26.7,2500,2306510,0.09
"1766",2018-12-25 14:50:13,26.65,200,2306710,0.01
"1756",2018-12-25 14:50:23,26.7,2000,2308710,0.07
"1746",2018-12-25 14:50:34,26.65,1000,2309710,0.04
"1736",2018-12-25 14:50:37,26.7,5000,2314710,0.18
"1726",2018-12-25 14:50:42,26.7,3850,2318560,0.14
"17110",2018-12-25 14:50:46,26.7,130,2318690,0
"1706",2018-12-25 14:51:06,26.7,100,2318790,0
"1696",2018-12-25 14:51:20,26.65,5000,2323790,0.18
"1686",2018-12-25 14:51:46,26.65,5200,2328990,0.19
"1676",2018-12-25 14:51:51,26.7,130,2329120,0
"1666",2018-12-25 14:51:53,26.7,5000,2334120,0.18
"1656",2018-12-25 14:51:58,26.7,2710,2336830,0.1
"1646",2018-12-25 14:52:03,26.7,500,2337330,0.02
"1636",2018-12-25 14:52:54,26.8,130,2337460,0
"1626",2018-12-25 14:53:02,26.8,5000,2342460,0.18
"16110",2018-12-25 14:53:13,26.8,1000,2343460,0.04
"1606",2018-12-25 14:53:20,26.8,5000,2348460,0.18
"1596",2018-12-25 14:53:29,26.8,3850,2352310,0.14
"1586",2018-12-25 14:53:47,26.8,5420,2357730,0.19
"1576",2018-12-25 14:53:58,26.85,130,2357860,0
"1566",2018-12-25 14:54:26,26.85,20,2357880,0
"1556",2018-12-25 14:54:42,26.9,10000,2367880,0.36
"1546",2018-12-25 14:54:45,26.85,100,2367980,0
"1536",2018-12-25 14:55:02,26.9,130,2368110,0
"1526",2018-12-25 14:55:12,26.85,400,2368510,0.01
"15110",2018-12-25 14:55:29,26.85,500,2369010,0.02
"1506",2018-12-25 14:55:42,26.85,1000,2370010,0.04
"1496",2018-12-25 14:55:46,26.85,100,2370110,0
"1486",2018-12-25 14:55:49,26.85,300,2370410,0.01
"1476",2018-12-25 14:55:51,26.9,3000,2373410,0.11
"1466",2018-12-25 14:56:06,26.9,130,2373540,0
"1456",2018-12-25 14:56:14,26.85,50,2373590,0
"1446",2018-12-25 14:56:57,26.9,5000,2378590,0.18
"1436",2018-12-25 14:57:05,26.85,200,2378790,0.01
"1426",2018-12-25 14:57:11,26.9,130,2378920,0
"14110",2018-12-25 14:57:17,26.9,500,2379420,0.02
"1406",2018-12-25 14:57:21,26.8,20000,2399420,0.71
"1396",2018-12-25 14:57:33,26.8,1000,2400420,0.04
"1386",2018-12-25 14:57:48,26.8,200,2400620,0.01
"1376",2018-12-25 14:57:58,26.8,700,2401320,0.02
"1366",2018-12-25 14:58:01,26.8,5000,2406320,0.18
"1356",2018-12-25 14:58:06,26.8,500,2406820,0.02
"1346",2018-12-25 14:58:13,26.8,10,2406830,0
"1336",2018-12-25 14:58:14,26.85,5000,2411830,0.18
"1326",2018-12-25 14:58:15,26.85,130,2411960,0
"13110",2018-12-25 14:58:30,26.8,20,2411980,0
"1306",2018-12-25 14:58:31,26.8,500,2412480,0.02
"1296",2018-12-25 14:58:47,26.8,100,2412580,0
"1286",2018-12-25 14:59:06,26.8,4150,2416730,0.15
"1276",2018-12-25 14:59:17,26.8,4000,2420730,0.14
"1266",2018-12-25 14:59:18,26.85,130,2420860,0
"1256",2018-12-25 14:59:20,26.8,2000,2422860,0.07
"1246",2018-12-25 14:59:28,26.8,1000,2423860,0.04
"1236",2018-12-25 14:59:33,26.8,800,2424660,0.03
"1226",2018-12-25 14:59:44,26.8,3390,2428050,0.12
"12110",2018-12-25 15:00:09,26.7,4000,2432050,0.14
"1206",2018-12-25 15:00:15,26.8,3000,2435050,0.11
"1196",2018-12-25 15:00:22,26.8,130,2435180,0
"1186",2018-12-25 15:00:24,26.8,500,2435680,0.02
"1176",2018-12-25 15:00:37,26.75,10,2435690,0
"1166",2018-12-25 15:00:47,26.7,8000,2443690,0.29
"1156",2018-12-25 15:00:48,26.7,9040,2452730,0.32
"1146",2018-12-25 15:00:57,26.7,10,2452740,0
"1136",2018-12-25 15:01:26,26.7,130,2452870,0
"1126",2018-12-25 15:01:34,26.7,40,2452910,0
"11110",2018-12-25 15:02:05,26.65,500,2453410,0.02
"11010",2018-12-25 15:02:27,26.65,200,2453610,0.01
"1096",2018-12-25 15:02:30,26.7,130,2453740,0
"1086",2018-12-25 15:02:31,26.65,490,2454230,0.02
"1076",2018-12-25 15:02:55,26.7,10,2454240,0
"1066",2018-12-25 15:03:02,26.7,1000,2455240,0.04
"1056",2018-12-25 15:03:15,26.7,10,2455250,0
"1046",2018-12-25 15:03:26,26.65,500,2455750,0.02
"1036",2018-12-25 15:03:34,26.7,130,2455880,0
"1026",2018-12-25 15:03:47,26.7,4050,2459930,0.14
"10110",2018-12-25 15:03:57,26.65,100,2460030,0
"1006",2018-12-25 15:04:21,26.65,300,2460330,0.01
"996",2018-12-25 15:04:38,26.7,130,2460460,0
"986",2018-12-25 15:04:43,26.7,3000,2463460,0.11
"976",2018-12-25 15:05:06,26.65,6300,2469760,0.22
"966",2018-12-25 15:05:09,26.65,5000,2474760,0.18
"956",2018-12-25 15:05:21,26.65,100,2474860,0
"946",2018-12-25 15:05:40,26.65,1460,2476320,0.05
"936",2018-12-25 15:05:42,26.65,130,2476450,0
"926",2018-12-25 15:06:19,26.65,2000,2478450,0.07
"9110",2018-12-25 15:06:21,26.65,4050,2482500,0.14
"906",2018-12-25 15:06:47,26.65,130,2482630,0
"8910",2018-12-25 15:06:48,26.6,500,2483130,0.02
"8810",2018-12-25 15:07:22,26.6,10000,2493130,0.36
"8710",2018-12-25 15:07:24,26.6,5000,2498130,0.18
"8610",2018-12-25 15:07:35,26.6,4800,2502930,0.17
"8510",2018-12-25 15:07:38,26.6,200,2503130,0.01
"8410",2018-12-25 15:07:42,26.6,850,2503980,0.03
"8310",2018-12-25 15:08:20,26.65,130,2504110,0
"8210",2018-12-25 15:08:27,26.65,1000,2505110,0.04
"8110",2018-12-25 15:08:29,26.65,10,2505120,0
"8010",2018-12-25 15:08:49,26.65,200,2505320,0.01
"7910",2018-12-25 15:08:54,26.65,130,2505450,0
"7810",2018-12-25 15:08:56,26.65,300,2505750,0.01
"7710",2018-12-25 15:09:49,26.65,3750,2509500,0.13
"7610",2018-12-25 15:09:55,26.6,3510,2513010,0.13
"7510",2018-12-25 15:09:58,26.6,130,2513140,0
"7410",2018-12-25 15:10:15,26.6,2470,2515610,0.09
"7310",2018-12-25 15:10:32,26.5,26980,2542590,0.96
"7210",2018-12-25 15:10:43,26.5,20000,2562590,0.71
"7110",2018-12-25 15:10:53,26.5,19000,2581590,0.68
"7010",2018-12-25 15:10:56,26.5,1000,2582590,0.04
"6910",2018-12-25 15:11:02,26.5,130,2582720,0
"6810",2018-12-25 15:11:04,26.5,6890,2589610,0.25
"6710",2018-12-25 15:11:23,26.5,300,2589910,0.01
"6610",2018-12-25 15:12:06,26.6,130,2590040,0
"6510",2018-12-25 15:12:46,26.6,500,2590540,0.02
"6410",2018-12-25 15:14:03,26.6,4050,2594590,0.14
"6310",2018-12-25 15:16:01,26.6,130,2594720,0
"6210",2018-12-25 15:17:27,26.55,100,2594820,0
"6110",2018-12-25 15:17:30,26.6,130,2594950,0
"6010",2018-12-25 15:17:32,26.55,4000,2598950,0.14
"5910",2018-12-25 15:17:39,26.55,10,2598960,0
"5810",2018-12-25 15:17:42,26.6,130,2599090,0
"5710",2018-12-25 15:17:44,26.6,1240,2600330,0.04
"5610",2018-12-25 15:17:46,26.6,200,2600530,0.01
"5510",2018-12-25 15:17:57,26.65,330,2600860,0.01
"5414",2018-12-25 15:18:00,26.65,4040,2604900,0.14
"5316",2018-12-25 15:18:01,26.65,1000,2605900,0.04
"5216",2018-12-25 15:18:06,26.6,6000,2611900,0.21
"5116",2018-12-25 15:18:11,26.65,130,2612030,0
"5016",2018-12-25 15:18:14,26.65,170,2612200,0.01
"4917",2018-12-25 15:18:17,26.65,530,2612730,0.02
"4817",2018-12-25 15:18:29,26.7,130,2612860,0
"4717",2018-12-25 15:18:48,26.7,200,2613060,0.01
"4617",2018-12-25 15:18:54,26.7,300,2613360,0.01
"4517",2018-12-25 15:18:57,26.7,16500,2629860,0.59
"4417",2018-12-25 15:19:13,26.7,170,2630030,0.01
"4317",2018-12-25 15:19:16,26.7,100,2630130,0
"4217",2018-12-25 15:19:33,26.75,130,2630260,0
"4117",2018-12-25 15:20:17,26.75,700,2630960,0.02
"4017",2018-12-25 15:20:22,26.75,270,2631230,0.01
"3917",2018-12-25 15:20:31,26.65,10800,2642030,0.39
"3818",2018-12-25 15:20:37,26.75,130,2642160,0
"3719",2018-12-25 15:20:46,26.7,500,2642660,0.02
"3619",2018-12-25 15:21:01,26.7,1000,2643660,0.04
"3519",2018-12-25 15:21:41,26.75,130,2643790,0
"3420",2018-12-25 15:21:51,26.75,900,2644690,0.03
"3320",2018-12-25 15:22:25,26.8,500,2645190,0.02
"3220",2018-12-25 15:22:28,26.75,300,2645490,0.01
"3120",2018-12-25 15:22:42,26.75,3830,2649320,0.14
"3020",2018-12-25 15:22:46,26.75,1130,2650450,0.04
"2920",2018-12-25 15:23:08,26.75,390,2650840,0.01
"2820",2018-12-25 15:23:28,26.75,2000,2652840,0.07
"2720",2018-12-25 15:23:49,26.8,130,2652970,0
"2620",2018-12-25 15:24:16,26.75,2000,2654970,0.07
"2520",2018-12-25 15:24:25,26.75,100,2655070,0
"2420",2018-12-25 15:24:53,26.8,130,2655200,0
"2320",2018-12-25 15:25:44,26.8,5020,2660220,0.18
"2220",2018-12-25 15:25:46,26.8,1000,2661220,0.04
"2120",2018-12-25 15:25:57,26.8,130,2661350,0
"2020",2018-12-25 15:25:59,26.8,2000,2663350,0.07
"1920",2018-12-25 15:26:11,26.8,5000,2668350,0.18
"1820",2018-12-25 15:26:13,26.8,370,2668720,0.01
"1720",2018-12-25 15:26:18,26.8,1000,2669720,0.04
"1620",2018-12-25 15:26:24,26.75,790,2670510,0.03
"1520",2018-12-25 15:26:31,26.8,240,2670750,0.01
"1420",2018-12-25 15:26:34,26.8,3000,2673750,0.11
"1320",2018-12-25 15:26:39,26.75,3000,2676750,0.11
"1220",2018-12-25 15:26:43,26.75,5000,2681750,0.18
"1120",2018-12-25 15:27:00,26.8,5100,2686850,0.18
"1020",2018-12-25 15:27:02,26.8,4780,2691630,0.17
"920",2018-12-25 15:27:03,26.8,370,2692000,0.01
"8100",2018-12-25 15:27:10,26.8,1000,2693000,0.04
"7100",2018-12-25 15:27:14,26.8,5000,2698000,0.18
"6100",2018-12-25 15:27:38,26.75,600,2698600,0.02
"5100",2018-12-25 15:28:05,26.8,2000,2700600,0.07
"4107",2018-12-25 15:28:43,26.8,2200,2702800,0.08
"3126",2018-12-25 15:29:18,26.85,200,2703000,0.01
"2127",2018-12-25 15:29:39,26.85,25000,2728000,0.89
"1127",2018-12-25 15:47:10,26.85,74250,2802250,2.65
"34110",2018-12-26 10:15:19,26.8,1720,1720,0.15
"3406",2018-12-26 10:15:34,26.85,4020,5740,0.36
"3396",2018-12-26 10:15:51,26.85,1320,7060,0.12
"3386",2018-12-26 10:16:32,26.85,200,7260,0.02
"3376",2018-12-26 10:16:41,27,2210,9470,0.2
"3366",2018-12-26 10:16:44,27,200,9670,0.02
"3356",2018-12-26 10:16:46,27,2000,11670,0.18
"3346",2018-12-26 10:16:52,27,300,11970,0.03
"3336",2018-12-26 10:16:59,27.1,500,12470,0.05
"3326",2018-12-26 10:17:00,27,290,12760,0.03
"33110",2018-12-26 10:17:15,27,500,13260,0.05
"3306",2018-12-26 10:17:49,26.85,4210,17470,0.38
"3296",2018-12-26 10:18:35,26.85,1000,18470,0.09
"3286",2018-12-26 10:18:38,26.85,250,18720,0.02
"3276",2018-12-26 10:18:40,26.85,500,19220,0.05
"3266",2018-12-26 10:19:27,26.85,1750,20970,0.16
"3256",2018-12-26 10:20:49,26.9,40,21010,0
"3246",2018-12-26 10:21:13,26.9,300,21310,0.03
"3236",2018-12-26 10:21:58,26.85,660,21970,0.06
"3226",2018-12-26 10:22:27,26.85,2000,23970,0.18
"32110",2018-12-26 10:22:35,26.8,4480,28450,0.4
"3206",2018-12-26 10:22:36,26.8,220,28670,0.02
"3196",2018-12-26 10:23:14,26.8,310,28980,0.03
"3186",2018-12-26 10:24:42,26.85,2000,30980,0.18
"3176",2018-12-26 10:25:10,26.8,10,30990,0
"3166",2018-12-26 10:26:30,26.85,100,31090,0.01
"3156",2018-12-26 10:26:36,26.85,900,31990,0.08
"3146",2018-12-26 10:27:37,26.8,4800,36790,0.43
"3136",2018-12-26 10:27:46,26.8,50,36840,0
"3127",2018-12-26 10:28:21,26.8,760,37600,0.07
"31110",2018-12-26 10:29:02,26.8,100,37700,0.01
"31010",2018-12-26 10:30:23,26.8,5290,42990,0.48
"3096",2018-12-26 10:31:11,26.8,710,43700,0.06
"3086",2018-12-26 10:31:14,26.8,60,43760,0.01
"3076",2018-12-26 10:31:46,26.8,30,43790,0
"3066",2018-12-26 10:32:21,26.8,5000,48790,0.45
"3057",2018-12-26 10:33:31,26.8,490,49280,0.04
"3047",2018-12-26 10:34:35,26.8,100,49380,0.01
"3037",2018-12-26 10:35:50,26.8,30,49410,0
"3027",2018-12-26 10:37:42,26.8,50,49460,0
"30111",2018-12-26 10:39:39,26.8,20,49480,0
"3007",2018-12-26 10:39:58,26.75,1970,51450,0.18
"2997",2018-12-26 10:40:51,26.7,2000,53450,0.18
"2987",2018-12-26 10:42:16,26.65,830,54280,0.07
"2977",2018-12-26 10:44:59,26.65,1000,55280,0.09
"2967",2018-12-26 10:45:53,26.7,2500,57780,0.23
"2957",2018-12-26 10:47:24,26.65,30,57810,0
"2947",2018-12-26 10:47:29,26.65,790,58600,0.07
"2937",2018-12-26 10:48:04,26.65,940,59540,0.08
"2927",2018-12-26 10:48:05,26.7,5000,64540,0.45
"29111",2018-12-26 10:49:21,26.6,1670,66210,0.15
"2907",2018-12-26 10:49:22,26.6,60,66270,0.01
"2897",2018-12-26 10:49:29,26.6,2370,68640,0.21
"2887",2018-12-26 10:50:37,26.6,510,69150,0.05
"2877",2018-12-26 10:51:45,26.65,1000,70150,0.09
"2867",2018-12-26 10:52:59,26.65,1500,71650,0.14
"2857",2018-12-26 10:53:45,26.7,1000,72650,0.09
"2847",2018-12-26 10:53:49,26.7,600,73250,0.05
"2837",2018-12-26 10:53:58,26.65,10,73260,0
"2827",2018-12-26 10:54:48,26.7,6960,80220,0.63
"28111",2018-12-26 10:57:11,26.75,1400,81620,0.13
"2807",2018-12-26 10:58:06,26.75,3830,85450,0.35
"2797",2018-12-26 10:58:24,26.7,10000,95450,0.9
"2787",2018-12-26 11:00:39,26.75,2800,98250,0.25
"2777",2018-12-26 11:01:23,26.8,1000,99250,0.09
"2767",2018-12-26 11:02:17,26.8,2370,101620,0.21
"2757",2018-12-26 11:03:06,26.8,330,101950,0.03
"2747",2018-12-26 11:04:53,26.85,4670,106620,0.42
"2737",2018-12-26 11:10:33,26.8,1000,107620,0.09
"2727",2018-12-26 11:11:11,26.8,200,107820,0.02
"27111",2018-12-26 11:15:16,26.8,2150,109970,0.19
"2707",2018-12-26 11:16:38,26.8,300,110270,0.03
"2697",2018-12-26 11:17:03,26.8,100,110370,0.01
"2687",2018-12-26 11:18:25,26.8,2450,112820,0.22
"2677",2018-12-26 11:18:49,26.75,2000,114820,0.18
"2667",2018-12-26 11:19:51,26.75,1000,115820,0.09
"2657",2018-12-26 11:19:57,26.8,100,115920,0.01
"2647",2018-12-26 11:20:02,26.8,2000,117920,0.18
"2637",2018-12-26 11:20:21,26.8,1650,119570,0.15
"2627",2018-12-26 11:20:23,26.8,10,119580,0
"26111",2018-12-26 11:23:10,26.8,200,119780,0.02
"2607",2018-12-26 11:27:02,26.7,5000,124780,0.45
"2597",2018-12-26 11:31:48,26.8,1000,125780,0.09
"2587",2018-12-26 11:32:44,26.8,300,126080,0.03
"2577",2018-12-26 11:33:05,26.8,1000,127080,0.09
"2567",2018-12-26 11:38:01,26.8,5440,132520,0.49
"2557",2018-12-26 11:41:06,26.8,1560,134080,0.14
"2547",2018-12-26 11:41:35,26.8,810,134890,0.07
"2537",2018-12-26 11:44:03,26.8,100,134990,0.01
"2527",2018-12-26 11:44:19,26.8,20,135010,0
"25111",2018-12-26 11:45:53,26.8,70,135080,0.01
"2507",2018-12-26 11:46:04,26.8,2300,137380,0.21
"2497",2018-12-26 11:47:11,26.8,1000,138380,0.09
"2487",2018-12-26 11:47:39,26.8,400,138780,0.04
"2477",2018-12-26 11:48:03,26.8,100,138880,0.01
"2467",2018-12-26 11:50:19,26.75,5000,143880,0.45
"2457",2018-12-26 11:50:51,26.75,500,144380,0.05
"2447",2018-12-26 11:51:54,26.8,400,144780,0.04
"2437",2018-12-26 11:52:16,26.8,2370,147150,0.21
"2427",2018-12-26 11:52:37,26.8,1000,148150,0.09
"24111",2018-12-26 11:52:57,26.8,430,148580,0.04
"2407",2018-12-26 11:53:37,26.8,19570,168150,1.76
"2397",2018-12-26 11:53:41,26.8,2430,170580,0.22
"2387",2018-12-26 11:53:43,26.8,800,171380,0.07
"2377",2018-12-26 11:54:36,26.85,2370,173750,0.21
"2367",2018-12-26 11:54:54,26.8,10000,183750,0.9
"2357",2018-12-26 11:55:11,26.8,200,183950,0.02
"2347",2018-12-26 11:55:17,26.8,500,184450,0.05
"2337",2018-12-26 11:56:09,26.8,1040,185490,0.09
"2327",2018-12-26 11:56:18,26.8,500,185990,0.05
"23111",2018-12-26 11:56:25,26.8,3960,189950,0.36
"2307",2018-12-26 11:57:18,26.8,1040,190990,0.09
"2297",2018-12-26 11:58:01,26.8,100,191090,0.01
"2287",2018-12-26 11:58:16,26.8,5000,196090,0.45
"2277",2018-12-26 12:03:01,26.8,5020,201110,0.45
"2267",2018-12-26 12:04:58,26.8,4790,205900,0.43
"2257",2018-12-26 12:06:10,26.8,210,206110,0.02
"2247",2018-12-26 12:06:51,26.8,30,206140,0
"2237",2018-12-26 12:07:26,26.75,1500,207640,0.14
"2227",2018-12-26 12:09:17,26.8,860,208500,0.08
"22111",2018-12-26 12:10:21,26.8,4140,212640,0.37
"2207",2018-12-26 12:12:14,26.75,100,212740,0.01
"2197",2018-12-26 12:16:35,26.75,1100,213840,0.1
"2187",2018-12-26 12:17:42,26.75,2000,215840,0.18
"2177",2018-12-26 12:18:04,26.8,200,216040,0.02
"2167",2018-12-26 12:18:23,26.75,930,216970,0.08
"2157",2018-12-26 12:18:46,26.75,2910,219880,0.26
"2147",2018-12-26 12:19:27,26.7,930,220810,0.08
"2137",2018-12-26 12:19:36,26.75,90,220900,0.01
"2128",2018-12-26 12:21:00,26.75,930,221830,0.08
"21111",2018-12-26 12:21:43,26.8,2530,224360,0.23
"21011",2018-12-26 12:21:54,26.75,650,225010,0.06
"2097",2018-12-26 12:22:40,26.7,930,225940,0.08
"2087",2018-12-26 12:23:49,26.75,1980,227920,0.18
"2077",2018-12-26 12:24:28,26.75,50,227970,0
"2067",2018-12-26 12:24:49,26.75,500,228470,0.05
"2057",2018-12-26 12:25:53,26.7,930,229400,0.08
"2047",2018-12-26 12:25:56,26.75,430,229830,0.04
"2037",2018-12-26 12:26:58,26.75,930,230760,0.08
"2027",2018-12-26 12:27:26,26.75,240,231000,0.02
"20111",2018-12-26 12:27:47,26.7,1000,232000,0.09
"2007",2018-12-26 12:28:06,26.7,2530,234530,0.23
"1997",2018-12-26 12:29:37,26.7,500,235030,0.05
"1987",2018-12-26 12:29:51,26.7,5000,240030,0.45
"1977",2018-12-26 14:01:03,26.7,13040,253070,1.17
"1967",2018-12-26 14:01:31,26.7,5000,258070,0.45
"1957",2018-12-26 14:01:33,26.7,1200,259270,0.11
"1947",2018-12-26 14:01:49,26.7,500,259770,0.05
"1937",2018-12-26 14:02:02,26.75,1600,261370,0.14
"1927",2018-12-26 14:04:08,26.75,3100,264470,0.28
"19111",2018-12-26 14:05:52,26.75,1600,266070,0.14
"1907",2018-12-26 14:06:09,26.7,450,266520,0.04
"1897",2018-12-26 14:06:50,26.75,2570,269090,0.23
"1887",2018-12-26 14:06:51,26.7,150,269240,0.01
"1877",2018-12-26 14:07:08,26.7,2000,271240,0.18
"1867",2018-12-26 14:07:42,26.75,1600,272840,0.14
"1857",2018-12-26 14:11:21,26.75,1900,274740,0.17
"1847",2018-12-26 14:11:28,26.75,1600,276340,0.14
"1837",2018-12-26 14:11:57,26.75,4400,280740,0.4
"1827",2018-12-26 14:12:26,26.75,3300,284040,0.3
"18111",2018-12-26 14:12:36,26.75,1750,285790,0.16
"1807",2018-12-26 14:12:49,26.7,550,286340,0.05
"1797",2018-12-26 14:13:21,26.7,1600,287940,0.14
"1787",2018-12-26 14:13:37,26.8,20490,308430,1.85
"1777",2018-12-26 14:14:33,26.8,10000,318430,0.9
"1767",2018-12-26 14:14:48,26.8,8050,326480,0.73
"1757",2018-12-26 14:15:17,26.85,1600,328080,0.14
"1747",2018-12-26 14:15:22,26.8,9000,337080,0.81
"1737",2018-12-26 14:15:32,26.85,2000,339080,0.18
"1727",2018-12-26 14:15:38,26.8,500,339580,0.05
"17111",2018-12-26 14:16:10,26.8,200,339780,0.02
"1707",2018-12-26 14:16:32,26.8,5000,344780,0.45
"1697",2018-12-26 14:16:52,26.85,10000,354780,0.9
"1687",2018-12-26 14:16:59,26.85,500,355280,0.05
"1677",2018-12-26 14:17:07,26.85,1600,356880,0.14
"1667",2018-12-26 14:19:19,26.85,3970,360850,0.36
"1657",2018-12-26 14:20:01,26.85,10000,370850,0.9
"1647",2018-12-26 14:20:12,26.85,100,370950,0.01
"1637",2018-12-26 14:20:44,26.85,18590,389540,1.67
"1627",2018-12-26 14:20:54,26.9,1600,391140,0.14
"16111",2018-12-26 14:21:19,26.9,10000,401140,0.9
"1607",2018-12-26 14:21:41,26.9,2370,403510,0.21
"1597",2018-12-26 14:22:38,26.9,3000,406510,0.27
"1587",2018-12-26 14:22:47,26.9,1600,408110,0.14
"1577",2018-12-26 14:23:30,26.9,7120,415230,0.64
"1567",2018-12-26 14:24:31,26.9,1000,416230,0.09
"1557",2018-12-26 14:24:40,26.95,1600,417830,0.14
"1547",2018-12-26 14:24:48,26.95,500,418330,0.05
"1537",2018-12-26 14:24:54,26.95,10,418340,0
"1527",2018-12-26 14:25:07,26.9,2000,420340,0.18
"15111",2018-12-26 14:26:19,26.95,1500,421840,0.14
"1507",2018-12-26 14:26:24,26.9,2000,423840,0.18
"1497",2018-12-26 14:26:28,26.9,8380,432220,0.75
"1487",2018-12-26 14:26:33,26.9,1600,433820,0.14
"1477",2018-12-26 14:27:29,26.85,1000,434820,0.09
"1467",2018-12-26 14:28:27,26.9,1600,436420,0.14
"1457",2018-12-26 14:29:54,26.85,1000,437420,0.09
"1447",2018-12-26 14:30:06,26.85,5000,442420,0.45
"1437",2018-12-26 14:30:20,26.9,1600,444020,0.14
"1427",2018-12-26 14:31:02,26.85,42000,486020,3.78
"14111",2018-12-26 14:31:14,26.85,4000,490020,0.36
"1407",2018-12-26 14:31:16,26.85,100,490120,0.01
"1397",2018-12-26 14:31:22,26.85,1550,491670,0.14
"1387",2018-12-26 14:32:13,26.85,1600,493270,0.14
"1377",2018-12-26 14:32:40,26.8,440,493710,0.04
"1367",2018-12-26 14:32:46,26.85,1180,494890,0.11
"1357",2018-12-26 14:32:59,26.8,3000,497890,0.27
"1347",2018-12-26 14:34:06,26.85,1600,499490,0.14
"1337",2018-12-26 14:34:17,26.8,3000,502490,0.27
"1327",2018-12-26 14:34:49,26.85,14630,517120,1.32
"13111",2018-12-26 14:35:03,26.85,160,517280,0.01
"1307",2018-12-26 14:35:41,26.85,200,517480,0.02
"1297",2018-12-26 14:35:43,26.85,5000,522480,0.45
"1287",2018-12-26 14:35:51,26.85,10,522490,0
"1277",2018-12-26 14:35:59,26.85,1600,524090,0.14
"1267",2018-12-26 14:36:17,26.85,1100,525190,0.1
"1257",2018-12-26 14:36:32,26.85,60,525250,0.01
"1247",2018-12-26 14:37:52,26.85,1600,526850,0.14
"1237",2018-12-26 14:40:31,26.8,76600,603450,6.9
"1227",2018-12-26 14:40:43,26.8,300,603750,0.03
"12111",2018-12-26 14:41:34,26.85,2370,606120,0.21
"1207",2018-12-26 14:41:39,26.85,1600,607720,0.14
"1197",2018-12-26 14:43:31,26.85,500,608220,0.05
"1187",2018-12-26 14:43:32,26.85,1600,609820,0.14
"1177",2018-12-26 14:43:43,26.85,300,610120,0.03
"1167",2018-12-26 14:43:47,26.85,1000,611120,0.09
"1157",2018-12-26 14:44:55,26.8,7000,618120,0.63
"1147",2018-12-26 14:45:12,26.8,1320,619440,0.12
"1137",2018-12-26 14:45:25,26.85,2920,622360,0.26
"1128",2018-12-26 14:47:14,26.85,110,622470,0.01
"11111",2018-12-26 14:47:17,26.85,300,622770,0.03
"11011",2018-12-26 14:47:18,26.85,1600,624370,0.14
"1097",2018-12-26 14:48:22,26.85,10,624380,0
"1087",2018-12-26 14:49:12,26.85,1600,625980,0.14
"1077",2018-12-26 14:50:30,26.85,500,626480,0.05
"1067",2018-12-26 14:50:33,26.8,200,626680,0.02
"1057",2018-12-26 14:50:54,26.85,10000,636680,0.9
"1047",2018-12-26 14:50:56,26.8,500,637180,0.05
"1037",2018-12-26 14:51:05,26.85,1600,638780,0.14
"1027",2018-12-26 14:51:31,26.8,1320,640100,0.12
"10111",2018-12-26 14:52:24,26.85,3690,643790,0.33
"1007",2018-12-26 14:52:49,26.8,10,643800,0
"997",2018-12-26 14:52:58,26.85,1600,645400,0.14
"987",2018-12-26 14:53:15,26.85,24780,670180,2.23
"977",2018-12-26 14:53:31,26.9,2370,672550,0.21
"967",2018-12-26 14:53:32,26.9,10000,682550,0.9
"957",2018-12-26 14:53:39,26.9,500,683050,0.05
"947",2018-12-26 14:53:54,26.9,10000,693050,0.9
"937",2018-12-26 14:53:59,26.9,500,693550,0.05
"927",2018-12-26 14:54:10,26.9,5000,698550,0.45
"9111",2018-12-26 14:54:11,26.85,35000,733550,3.15
"907",2018-12-26 14:54:51,26.9,1600,735150,0.14
"8912",2018-12-26 14:54:55,26.85,2550,737700,0.23
"8812",2018-12-26 14:54:56,26.85,11000,748700,0.99
"8712",2018-12-26 14:55:00,26.9,2920,751620,0.26
"8612",2018-12-26 14:55:06,26.95,3000,754620,0.27
"8512",2018-12-26 14:55:31,26.95,1000,755620,0.09
"8412",2018-12-26 14:55:38,26.95,2000,757620,0.18
"8312",2018-12-26 14:55:45,26.95,9280,766900,0.84
"8212",2018-12-26 14:56:05,26.95,5000,771900,0.45
"8112",2018-12-26 14:56:26,26.95,2720,774620,0.25
"8012",2018-12-26 14:56:32,26.95,280,774900,0.03
"7912",2018-12-26 14:56:36,26.95,1000,775900,0.09
"7812",2018-12-26 14:56:44,27,1600,777500,0.14
"7712",2018-12-26 14:56:52,27,500,778000,0.05
"7612",2018-12-26 14:56:54,27,6000,784000,0.54
"7512",2018-12-26 14:56:55,26.95,320,784320,0.03
"7412",2018-12-26 14:57:52,26.9,100,784420,0.01
"7312",2018-12-26 14:57:53,26.95,6000,790420,0.54
"7212",2018-12-26 14:57:56,27,10000,800420,0.9
"7112",2018-12-26 14:58:07,27,20,800440,0
"7012",2018-12-26 14:58:40,27,1600,802040,0.14
"6912",2018-12-26 14:58:41,26.95,100,802140,0.01
"6812",2018-12-26 14:58:54,27,10000,812140,0.9
"6712",2018-12-26 14:59:07,27,2000,814140,0.18
"6612",2018-12-26 14:59:30,27,10000,824140,0.9
"6512",2018-12-26 14:59:44,26.95,5000,829140,0.45
"6412",2018-12-26 15:00:31,27,1600,830740,0.14
"6312",2018-12-26 15:00:51,27,380,831120,0.03
"6212",2018-12-26 15:01:29,27,20,831140,0
"6112",2018-12-26 15:01:56,26.95,10000,841140,0.9
"6012",2018-12-26 15:02:24,27,1600,842740,0.14
"5912",2018-12-26 15:02:33,26.95,17000,859740,1.53
"5812",2018-12-26 15:02:43,26.95,2000,861740,0.18
"5712",2018-12-26 15:03:29,26.95,1000,862740,0.09
"5612",2018-12-26 15:03:33,26.95,10,862750,0
"5512",2018-12-26 15:04:05,26.95,1560,864310,0.14
"5415",2018-12-26 15:04:17,26.95,1600,865910,0.14
"5317",2018-12-26 15:06:46,26.95,2600,868510,0.23
"5217",2018-12-26 15:07:21,26.9,20000,888510,1.8
"5117",2018-12-26 15:08:27,26.95,1600,890110,0.14
"5017",2018-12-26 15:08:31,26.9,1000,891110,0.09
"4918",2018-12-26 15:08:32,26.9,1480,892590,0.13
"4818",2018-12-26 15:08:47,26.85,50,892640,0
"4718",2018-12-26 15:09:57,26.9,1600,894240,0.14
"4618",2018-12-26 15:10:42,26.9,500,894740,0.05
"4518",2018-12-26 15:11:50,26.9,1600,896340,0.14
"4418",2018-12-26 15:11:54,26.9,500,896840,0.05
"4318",2018-12-26 15:12:09,26.9,5000,901840,0.45
"4218",2018-12-26 15:13:07,26.9,1000,902840,0.09
"4118",2018-12-26 15:13:43,26.9,2600,905440,0.23
"4018",2018-12-26 15:17:19,26.9,2600,908040,0.23
"3918",2018-12-26 15:17:20,26.85,5000,913040,0.45
"3819",2018-12-26 15:17:22,26.9,1000,914040,0.09
"3720",2018-12-26 15:17:32,26.9,1600,915640,0.14
"3620",2018-12-26 15:19:11,26.9,560,916200,0.05
"3520",2018-12-26 15:19:18,26.9,4000,920200,0.36
"3426",2018-12-26 15:19:22,26.9,1600,921800,0.14
"3327",2018-12-26 15:19:51,26.85,740,922540,0.07
"3227",2018-12-26 15:20:00,26.85,6600,929140,0.59
"3128",2018-12-26 15:20:23,26.85,790,929930,0.07
"3028",2018-12-26 15:20:30,26.85,10000,939930,0.9
"2928",2018-12-26 15:20:44,26.85,1000,940930,0.09
"2828",2018-12-26 15:21:16,26.9,2600,943530,0.23
"2728",2018-12-26 15:21:20,26.85,280,943810,0.03
"2628",2018-12-26 15:21:50,26.85,5000,948810,0.45
"2528",2018-12-26 15:21:57,26.85,3000,951810,0.27
"2428",2018-12-26 15:22:31,26.85,40,951850,0
"2328",2018-12-26 15:23:09,26.85,1600,953450,0.14
"2228",2018-12-26 15:23:20,26.85,1000,954450,0.09
"2129",2018-12-26 15:23:44,26.85,100,954550,0.01
"2028",2018-12-26 15:24:09,26.8,8000,962550,0.72
"1928",2018-12-26 15:24:27,26.8,3000,965550,0.27
"1828",2018-12-26 15:24:46,26.85,3800,969350,0.34
"1728",2018-12-26 15:24:57,26.8,1640,970990,0.15
"1628",2018-12-26 15:25:03,26.85,1600,972590,0.14
"1528",2018-12-26 15:25:09,26.8,750,973340,0.07
"1428",2018-12-26 15:25:32,26.65,5000,978340,0.45
"1328",2018-12-26 15:26:31,26.8,100,978440,0.01
"1228",2018-12-26 15:26:34,26.7,400,978840,0.04
"1129",2018-12-26 15:27:12,26.65,3960,982800,0.36
"1028",2018-12-26 15:27:27,26.65,150,982950,0.01
"928",2018-12-26 15:27:34,26.7,2000,984950,0.18
"8102",2018-12-26 15:27:47,26.65,1000,985950,0.09
"7102",2018-12-26 15:27:55,26.7,800,986750,0.07
"6102",2018-12-26 15:28:09,26.7,3500,990250,0.32
"5102",2018-12-26 15:28:32,26.65,1300,991550,0.12
"4108",2018-12-26 15:28:35,26.7,2000,993550,0.18
"3129",2018-12-26 15:29:01,26.7,1000,994550,0.09
"2130",2018-12-26 15:29:44,26.65,9000,1003550,0.81
"1130",2018-12-26 15:47:00,26.65,106530,1110080,9.6
"4253",2018-12-27 10:15:22,27.2,45330,45330,3.76
"4243",2018-12-27 10:15:33,27,10000,55330,0.83
"4233",2018-12-27 10:16:17,27.1,1000,56330,0.08
"4223",2018-12-27 10:16:37,27.2,880,57210,0.07
"4219",2018-12-27 10:16:48,27.2,10,57220,0
"4203",2018-12-27 10:16:53,27.2,1000,58220,0.08
"4193",2018-12-27 10:17:03,27.2,3570,61790,0.3
"4183",2018-12-27 10:17:15,27.3,1300,63090,0.11
"4173",2018-12-27 10:17:33,27.3,1900,64990,0.16
"4163",2018-12-27 10:17:36,27.4,1080,66070,0.09
"4153",2018-12-27 10:17:45,27.4,1000,67070,0.08
"4143",2018-12-27 10:18:02,27.4,1180,68250,0.1
"4133",2018-12-27 10:18:21,27.3,200,68450,0.02
"4123",2018-12-27 10:18:27,27.3,550,69000,0.05
"4119",2018-12-27 10:18:32,27.3,250,69250,0.02
"4109",2018-12-27 10:18:52,27.3,260,69510,0.02
"4093",2018-12-27 10:18:53,27.3,240,69750,0.02
"4083",2018-12-27 10:19:09,27.3,490,70240,0.04
"4073",2018-12-27 10:19:16,27.3,1000,71240,0.08
"4063",2018-12-27 10:19:30,27.3,100,71340,0.01
"4053",2018-12-27 10:19:37,27.35,10,71350,0
"4043",2018-12-27 10:19:52,27.35,1000,72350,0.08
"4033",2018-12-27 10:20:01,27.35,500,72850,0.04
"4023",2018-12-27 10:20:33,27.3,10,72860,0
"4019",2018-12-27 10:20:49,27.3,5070,77930,0.42
"4003",2018-12-27 10:21:03,27.25,2000,79930,0.17
"3993",2018-12-27 10:21:30,27.25,1000,80930,0.08
"3983",2018-12-27 10:21:31,27.25,5000,85930,0.41
"3973",2018-12-27 10:21:36,27.25,50,85980,0
"3963",2018-12-27 10:21:37,27.25,760,86740,0.06
"3953",2018-12-27 10:21:42,27.25,500,87240,0.04
"3943",2018-12-27 10:22:22,27.2,5330,92570,0.44
"3933",2018-12-27 10:22:55,27.25,1080,93650,0.09
"3923",2018-12-27 10:23:00,27.25,4000,97650,0.33
"3919",2018-12-27 10:23:21,27.2,1720,99370,0.14
"3903",2018-12-27 10:23:47,27.25,500,99870,0.04
"3893",2018-12-27 10:24:11,27.25,600,100470,0.05
"3883",2018-12-27 10:24:16,27.25,30,100500,0
"3873",2018-12-27 10:25:05,27.25,1070,101570,0.09
"3863",2018-12-27 10:25:17,27.25,600,102170,0.05
"3853",2018-12-27 10:25:46,27.2,100,102270,0.01
"3843",2018-12-27 10:26:11,27.3,2000,104270,0.17
"3833",2018-12-27 10:26:17,27.2,330,104600,0.03
"3824",2018-12-27 10:26:36,27.2,8000,112600,0.66
"38110",2018-12-27 10:27:17,27.2,2000,114600,0.17
"3804",2018-12-27 10:27:42,27.2,2030,116630,0.17
"3794",2018-12-27 10:27:45,27.2,1000,117630,0.08
"3784",2018-12-27 10:27:48,27.2,5000,122630,0.41
"3775",2018-12-27 10:28:03,27.2,6000,128630,0.5
"3765",2018-12-27 10:28:10,27.2,1900,130530,0.16
"3755",2018-12-27 10:28:12,27.25,700,131230,0.06
"3745",2018-12-27 10:28:23,27.25,380,131610,0.03
"3735",2018-12-27 10:28:53,27.25,120,131730,0.01
"3725",2018-12-27 10:28:57,27.25,1300,133030,0.11
"37110",2018-12-27 10:29:13,27.25,2000,135030,0.17
"3705",2018-12-27 10:30:49,27.2,2100,137130,0.17
"3695",2018-12-27 10:32:09,27.2,20,137150,0
"3685",2018-12-27 10:32:51,27.2,1000,138150,0.08
"3675",2018-12-27 10:33:31,27.25,2080,140230,0.17
"3665",2018-12-27 10:34:21,27.25,250,140480,0.02
"3655",2018-12-27 10:35:03,27.25,1500,141980,0.12
"3645",2018-12-27 10:35:29,27.25,5000,146980,0.41
"3635",2018-12-27 10:35:32,27.25,200,147180,0.02
"3625",2018-12-27 10:35:36,27.25,400,147580,0.03
"36110",2018-12-27 10:36:18,27.25,1000,148580,0.08
"3605",2018-12-27 10:36:23,27.25,250,148830,0.02
"3595",2018-12-27 10:36:58,27.25,120,148950,0.01
"3585",2018-12-27 10:37:57,27.25,3000,151950,0.25
"3575",2018-12-27 10:38:00,27.2,100,152050,0.01
"3565",2018-12-27 10:38:23,27.2,2000,154050,0.17
"3555",2018-12-27 10:38:51,27.25,1080,155130,0.09
"3545",2018-12-27 10:39:28,27.25,5000,160130,0.41
"3535",2018-12-27 10:40:35,27.2,3000,163130,0.25
"3525",2018-12-27 10:42:21,27.2,10000,173130,0.83
"35110",2018-12-27 10:42:38,27.2,150,173280,0.01
"3505",2018-12-27 10:42:50,27.2,280,173560,0.02
"3496",2018-12-27 10:43:36,27.25,10000,183560,0.83
"3486",2018-12-27 10:44:09,27.25,1080,184640,0.09
"3476",2018-12-27 10:44:34,27.25,5000,189640,0.41
"3466",2018-12-27 10:45:12,27.2,10500,200140,0.87
"3456",2018-12-27 10:46:40,27.2,1000,201140,0.08
"3446",2018-12-27 10:47:29,27.2,30000,231140,2.49
"3436",2018-12-27 10:47:44,27.2,100,231240,0.01
"3427",2018-12-27 10:48:01,27.2,10100,241340,0.84
"34111",2018-12-27 10:48:26,27.2,4210,245550,0.35
"3407",2018-12-27 10:48:31,27.2,20,245570,0
"3397",2018-12-27 10:48:37,27.25,2500,248070,0.21
"3387",2018-12-27 10:49:28,27.2,380,248450,0.03
"3377",2018-12-27 10:49:37,27.2,700,249150,0.06
"3367",2018-12-27 10:51:04,27.2,500,249650,0.04
"3357",2018-12-27 10:51:10,27.2,200,249850,0.02
"3347",2018-12-27 10:52:09,27.15,250,250100,0.02
"3337",2018-12-27 10:53:03,27.2,60,250160,0
"3328",2018-12-27 10:53:10,27.15,20,250180,0
"33111",2018-12-27 10:53:16,27.15,10000,260180,0.83
"3307",2018-12-27 10:53:46,27.15,17000,277180,1.41
"3297",2018-12-27 10:54:00,27.15,950,278130,0.08
"3287",2018-12-27 10:54:46,27.15,1080,279210,0.09
"3277",2018-12-27 10:55:00,27.1,5000,284210,0.41
"3267",2018-12-27 10:55:37,27.1,10000,294210,0.83
"3257",2018-12-27 10:56:28,27.1,750,294960,0.06
"3247",2018-12-27 10:56:37,27.15,200,295160,0.02
"3237",2018-12-27 10:56:54,27.15,1000,296160,0.08
"3228",2018-12-27 10:57:34,27.15,370,296530,0.03
"32111",2018-12-27 10:57:45,27.2,10000,306530,0.83
"3207",2018-12-27 10:57:52,27.2,3000,309530,0.25
"3197",2018-12-27 11:00:04,27.15,100,309630,0.01
"3187",2018-12-27 11:00:05,27.2,1080,310710,0.09
"3177",2018-12-27 11:01:08,27.2,2370,313080,0.2
"3167",2018-12-27 11:01:39,27.2,3130,316210,0.26
"3157",2018-12-27 11:02:03,27.15,1000,317210,0.08
"3147",2018-12-27 11:03:55,27.2,2370,319580,0.2
"3137",2018-12-27 11:04:52,27.2,3470,323050,0.29
"31210",2018-12-27 11:05:08,27.2,2370,325420,0.2
"31111",2018-12-27 11:05:27,27.2,3450,328870,0.29
"31011",2018-12-27 11:05:29,27.2,10000,338870,0.83
"3097",2018-12-27 11:07:18,27.15,100,338970,0.01
"3087",2018-12-27 11:08:23,27.25,3000,341970,0.25
"3077",2018-12-27 11:08:37,27.15,1500,343470,0.12
"3067",2018-12-27 11:08:49,27.2,1000,344470,0.08
"3058",2018-12-27 11:09:02,27.2,100,344570,0.01
"3048",2018-12-27 11:09:21,27.2,300,344870,0.02
"3038",2018-12-27 11:10:42,27.25,1080,345950,0.09
"3029",2018-12-27 11:11:24,27.25,50,346000,0
"30112",2018-12-27 11:11:28,27.25,80,346080,0.01
"3008",2018-12-27 11:11:52,27.25,200,346280,0.02
"2998",2018-12-27 11:12:30,27.2,1000,347280,0.08
"2988",2018-12-27 11:16:00,27.25,1080,348360,0.09
"2978",2018-12-27 11:20:18,27.25,100,348460,0.01
"2968",2018-12-27 11:21:20,27.25,1080,349540,0.09
"2958",2018-12-27 11:23:08,27.25,720,350260,0.06
"2948",2018-12-27 11:26:38,27.25,1080,351340,0.09
"2938",2018-12-27 11:30:14,27.2,1000,352340,0.08
"2929",2018-12-27 11:31:57,27.25,1080,353420,0.09
"29112",2018-12-27 11:33:01,27.25,160,353580,0.01
"2908",2018-12-27 11:37:16,27.2,40,353620,0
"2898",2018-12-27 11:37:17,27.25,1080,354700,0.09
"2888",2018-12-27 11:38:02,27.2,720,355420,0.06
"2878",2018-12-27 11:38:23,27.2,20,355440,0
"2868",2018-12-27 11:38:52,27.2,1430,356870,0.12
"2858",2018-12-27 11:39:16,27.25,2370,359240,0.2
"2848",2018-12-27 11:39:46,27.2,720,359960,0.06
"2838",2018-12-27 11:40:38,27.2,80,360040,0.01
"2829",2018-12-27 11:40:43,27.2,200,360240,0.02
"28112",2018-12-27 11:40:56,27.2,1000,361240,0.08
"2808",2018-12-27 11:41:03,27.25,2370,363610,0.2
"2798",2018-12-27 11:41:30,27.2,720,364330,0.06
"2788",2018-12-27 11:41:53,27.2,1000,365330,0.08
"2778",2018-12-27 11:42:33,27.25,2080,367410,0.17
"2768",2018-12-27 11:42:45,27.25,9370,376780,0.78
"2758",2018-12-27 11:43:00,27.2,100,376880,0.01
"2748",2018-12-27 11:43:14,27.2,720,377600,0.06
"2738",2018-12-27 11:43:21,27.2,100,377700,0.01
"2729",2018-12-27 11:44:58,27.2,720,378420,0.06
"27112",2018-12-27 11:45:11,27.2,3000,381420,0.25
"2708",2018-12-27 11:45:46,27.2,2000,383420,0.17
"2698",2018-12-27 11:46:03,27.2,5000,388420,0.41
"2688",2018-12-27 11:46:24,27.2,1000,389420,0.08
"2678",2018-12-27 11:46:42,27.2,1720,391140,0.14
"2668",2018-12-27 11:47:09,27.2,100,391240,0.01
"2658",2018-12-27 11:47:18,27.2,10,391250,0
"2648",2018-12-27 11:47:20,27.2,1000,392250,0.08
"2638",2018-12-27 11:47:23,27.2,3500,395750,0.29
"2629",2018-12-27 11:47:51,27.2,5000,400750,0.41
"26112",2018-12-27 11:47:53,27.25,1080,401830,0.09
"2608",2018-12-27 11:48:26,27.2,720,402550,0.06
"2598",2018-12-27 11:49:28,27.25,10,402560,0
"2588",2018-12-27 11:49:45,27.2,500,403060,0.04
"2578",2018-12-27 11:49:58,27.2,20,403080,0
"2568",2018-12-27 11:50:09,27.25,1000,404080,0.08
"2558",2018-12-27 11:50:10,27.2,720,404800,0.06
"2548",2018-12-27 11:51:13,27.3,44440,449240,3.68
"2538",2018-12-27 11:51:41,27.3,2900,452140,0.24
"2529",2018-12-27 11:51:54,27.3,720,452860,0.06
"25112",2018-12-27 11:52:15,27.3,100,452960,0.01
"2508",2018-12-27 11:53:10,27.35,1080,454040,0.09
"2498",2018-12-27 11:53:39,27.3,720,454760,0.06
"2488",2018-12-27 11:58:30,27.3,1540,456300,0.13
"2478",2018-12-27 11:58:51,27.3,720,457020,0.06
"2468",2018-12-27 11:59:11,27.3,140,457160,0.01
"2458",2018-12-27 11:59:52,27.3,20,457180,0
"2448",2018-12-27 12:00:25,27.3,100,457280,0.01
"2438",2018-12-27 12:00:35,27.3,720,458000,0.06
"2429",2018-12-27 12:01:44,27.3,50,458050,0
"24112",2018-12-27 12:02:06,27.3,100,458150,0.01
"2408",2018-12-27 12:02:19,27.2,720,458870,0.06
"2398",2018-12-27 12:03:52,27.35,1080,459950,0.09
"2388",2018-12-27 12:04:03,27.3,720,460670,0.06
"2378",2018-12-27 12:06:03,27.35,3090,463760,0.26
"2368",2018-12-27 12:06:32,27.35,2000,465760,0.17
"2358",2018-12-27 12:06:55,27.35,2370,468130,0.2
"2348",2018-12-27 12:07:31,27.25,720,468850,0.06
"2338",2018-12-27 12:09:07,27.35,1080,469930,0.09
"2329",2018-12-27 12:09:15,27.25,720,470650,0.06
"23112",2018-12-27 12:12:12,27.3,1220,471870,0.1
"2308",2018-12-27 12:12:55,27.3,1210,473080,0.1
"2298",2018-12-27 12:12:56,27.3,2200,475280,0.18
"2288",2018-12-27 12:13:01,27.3,1370,476650,0.11
"2278",2018-12-27 12:14:25,27.3,1080,477730,0.09
"2268",2018-12-27 12:14:27,27.25,710,478440,0.06
"2258",2018-12-27 12:15:44,27.3,1000,479440,0.08
"2248",2018-12-27 12:15:48,27.25,100,479540,0.01
"2238",2018-12-27 12:16:11,27.25,710,480250,0.06
"2229",2018-12-27 12:16:41,27.3,7000,487250,0.58
"22112",2018-12-27 12:17:01,27.3,660,487910,0.05
"2208",2018-12-27 12:17:55,27.3,710,488620,0.06
"2198",2018-12-27 12:19:44,27.35,1790,490410,0.15
"2188",2018-12-27 12:19:49,27.35,170,490580,0.01
"2178",2018-12-27 12:20:05,27.3,100,490680,0.01
"2168",2018-12-27 12:20:10,27.35,510,491190,0.04
"2158",2018-12-27 12:20:12,27.35,100,491290,0.01
"2148",2018-12-27 12:21:23,27.3,710,492000,0.06
"2138",2018-12-27 12:22:05,27.35,120,492120,0.01
"21210",2018-12-27 12:22:58,27.35,1000,493120,0.08
"21112",2018-12-27 12:23:07,27.3,710,493830,0.06
"21012",2018-12-27 12:24:00,27.35,530,494360,0.04
"2098",2018-12-27 12:24:43,27.3,100,494460,0.01
"2088",2018-12-27 12:24:51,27.3,710,495170,0.06
"2078",2018-12-27 12:24:58,27.3,500,495670,0.04
"2068",2018-12-27 12:25:03,27.35,1080,496750,0.09
"2058",2018-12-27 12:25:48,27.3,5000,501750,0.41
"2048",2018-12-27 12:26:35,27.3,710,502460,0.06
"2038",2018-12-27 12:27:55,27.35,4000,506460,0.33
"2029",2018-12-27 12:28:18,27.35,1000,507460,0.08
"20112",2018-12-27 12:28:20,27.3,710,508170,0.06
"2008",2018-12-27 12:28:48,27.3,14000,522170,1.16
"1998",2018-12-27 12:29:32,27.35,400,522570,0.03
"1988",2018-12-27 12:29:39,27.35,150,522720,0.01
"1978",2018-12-27 14:01:12,27.4,30410,553130,2.52
"1968",2018-12-27 14:01:17,27.35,5000,558130,0.41
"1958",2018-12-27 14:01:18,27.4,1080,559210,0.09
"1948",2018-12-27 14:01:21,27.45,42800,602010,3.55
"1938",2018-12-27 14:01:48,27.35,710,602720,0.06
"1929",2018-12-27 14:03:07,27.4,50,602770,0
"19112",2018-12-27 14:03:32,27.35,710,603480,0.06
"1908",2018-12-27 14:03:42,27.35,100,603580,0.01
"1898",2018-12-27 14:04:33,27.45,1080,604660,0.09
"1888",2018-12-27 14:04:53,27.35,3500,608160,0.29
"1878",2018-12-27 14:05:16,27.35,710,608870,0.06
"1868",2018-12-27 14:05:28,27.35,100,608970,0.01
"1858",2018-12-27 14:05:40,27.35,230,609200,0.02
"1848",2018-12-27 14:06:42,27.4,3060,612260,0.25
"1838",2018-12-27 14:07:00,27.4,710,612970,0.06
"1829",2018-12-27 14:07:04,27.4,1330,614300,0.11
"18112",2018-12-27 14:08:03,27.4,1080,615380,0.09
"1808",2018-12-27 14:08:44,27.35,710,616090,0.06
"1798",2018-12-27 14:09:14,27.4,20000,636090,1.66
"1788",2018-12-27 14:09:21,27.35,2640,638730,0.22
"1778",2018-12-27 14:10:28,27.35,710,639440,0.06
"1768",2018-12-27 14:10:52,27.35,2520,641960,0.21
"1758",2018-12-27 14:11:33,27.4,1080,643040,0.09
"1748",2018-12-27 14:12:12,27.35,710,643750,0.06
"1738",2018-12-27 14:13:40,27.35,500,644250,0.04
"1729",2018-12-27 14:13:56,27.35,710,644960,0.06
"17112",2018-12-27 14:14:13,27.35,800,645760,0.07
"1708",2018-12-27 14:14:20,27.35,5540,651300,0.46
"1698",2018-12-27 14:14:53,27.3,890,652190,0.07
"1688",2018-12-27 14:14:55,27.35,1000,653190,0.08
"1678",2018-12-27 14:15:03,27.35,1080,654270,0.09
"1668",2018-12-27 14:15:06,27.35,2380,656650,0.2
"1658",2018-12-27 14:15:09,27.35,50,656700,0
"1648",2018-12-27 14:15:40,27.35,710,657410,0.06
"1638",2018-12-27 14:15:42,27.35,2860,660270,0.24
"1629",2018-12-27 14:15:51,27.35,80,660350,0.01
"16112",2018-12-27 14:17:24,27.3,710,661060,0.06
"1608",2018-12-27 14:18:35,27.35,1080,662140,0.09
"1598",2018-12-27 14:19:08,27.3,710,662850,0.06
"1588",2018-12-27 14:20:46,27.35,100,662950,0.01
"1578",2018-12-27 14:20:52,27.3,710,663660,0.06
"1568",2018-12-27 14:21:30,27.3,170,663830,0.01
"1558",2018-12-27 14:22:03,27.35,1080,664910,0.09
"1548",2018-12-27 14:22:36,27.3,710,665620,0.06
"1538",2018-12-27 14:25:08,27.35,1820,667440,0.15
"1529",2018-12-27 14:25:33,27.35,1080,668520,0.09
"15112",2018-12-27 14:26:04,27.3,710,669230,0.06
"1508",2018-12-27 14:26:38,27.35,3070,672300,0.25
"1498",2018-12-27 14:27:08,27.35,1930,674230,0.16
"1488",2018-12-27 14:27:39,27.35,10,674240,0
"1478",2018-12-27 14:27:48,27.3,710,674950,0.06
"1468",2018-12-27 14:27:51,27.35,100,675050,0.01
"1458",2018-12-27 14:28:21,27.35,50,675100,0
"1448",2018-12-27 14:29:04,27.35,1080,676180,0.09
"1438",2018-12-27 14:29:26,27.3,10000,686180,0.83
"1429",2018-12-27 14:29:28,27.35,10,686190,0
"14112",2018-12-27 14:29:32,27.3,710,686900,0.06
"1408",2018-12-27 14:29:39,27.35,360,687260,0.03
"1398",2018-12-27 14:31:14,27.3,2000,689260,0.17
"1388",2018-12-27 14:31:16,27.3,710,689970,0.06
"1378",2018-12-27 14:32:33,27.35,1080,691050,0.09
"1368",2018-12-27 14:32:34,27.3,10000,701050,0.83
"1358",2018-12-27 14:33:01,27.3,710,701760,0.06
"1348",2018-12-27 14:33:38,27.3,1000,702760,0.08
"1338",2018-12-27 14:34:08,27.3,6000,708760,0.5
"1329",2018-12-27 14:34:45,27.3,710,709470,0.06
"13112",2018-12-27 14:35:04,27.3,120,709590,0.01
"1308",2018-12-27 14:36:04,27.35,1080,710670,0.09
"1298",2018-12-27 14:36:29,27.3,710,711380,0.06
"1288",2018-12-27 14:37:11,27.3,140,711520,0.01
"1278",2018-12-27 14:37:21,27.3,140,711660,0.01
"1268",2018-12-27 14:37:28,27.3,450,712110,0.04
"1258",2018-12-27 14:38:13,27.25,710,712820,0.06
"1248",2018-12-27 14:39:15,27.25,2000,714820,0.17
"1238",2018-12-27 14:39:18,27.25,4000,718820,0.33
"1229",2018-12-27 14:39:25,27.25,1000,719820,0.08
"12112",2018-12-27 14:39:33,27.3,1080,720900,0.09
"1208",2018-12-27 14:39:38,27.2,140220,861120,11.62
"1198",2018-12-27 14:39:54,27.2,2370,863490,0.2
"1188",2018-12-27 14:39:57,27.15,710,864200,0.06
"1178",2018-12-27 14:40:46,27.15,1000,865200,0.08
"1168",2018-12-27 14:41:41,27.15,710,865910,0.06
"1158",2018-12-27 14:41:48,27.15,2000,867910,0.17
"1148",2018-12-27 14:42:34,27.2,100,868010,0.01
"1138",2018-12-27 14:42:36,27.15,1100,869110,0.09
"11210",2018-12-27 14:42:49,27.2,200,869310,0.02
"11112",2018-12-27 14:43:06,27.2,1080,870390,0.09
"11012",2018-12-27 14:43:07,27.15,2000,872390,0.17
"1098",2018-12-27 14:43:23,27.15,870,873260,0.07
"1088",2018-12-27 14:43:25,27.15,710,873970,0.06
"1078",2018-12-27 14:43:33,27.15,1700,875670,0.14
"1068",2018-12-27 14:44:30,27.15,10,875680,0
"1058",2018-12-27 14:45:23,27.2,1210,876890,0.1
"1048",2018-12-27 14:46:33,27.2,1080,877970,0.09
"1038",2018-12-27 14:46:36,27.15,850,878820,0.07
"1029",2018-12-27 14:46:38,27.2,100,878920,0.01
"10112",2018-12-27 14:46:51,27.15,410,879330,0.03
"1008",2018-12-27 14:46:53,27.15,710,880040,0.06
"998",2018-12-27 14:47:35,27.15,1000,881040,0.08
"988",2018-12-27 14:48:37,27.15,710,881750,0.06
"978",2018-12-27 14:49:36,27.15,20,881770,0
"968",2018-12-27 14:50:03,27.15,1080,882850,0.09
"958",2018-12-27 14:50:21,27.1,710,883560,0.06
"948",2018-12-27 14:50:23,27.15,100,883660,0.01
"938",2018-12-27 14:50:30,27.15,10,883670,0
"929",2018-12-27 14:50:56,27.15,140,883810,0.01
"9112",2018-12-27 14:51:26,27.15,320,884130,0.03
"908",2018-12-27 14:52:05,27.15,710,884840,0.06
"8913",2018-12-27 14:52:15,27.15,1000,885840,0.08
"8813",2018-12-27 14:52:16,27.15,290,886130,0.02
"8713",2018-12-27 14:52:37,27.15,2000,888130,0.17
"8613",2018-12-27 14:53:33,27.2,1080,889210,0.09
"8513",2018-12-27 14:53:49,27.15,710,889920,0.06
"8413",2018-12-27 14:54:33,27.2,1000,890920,0.08
"8313",2018-12-27 14:55:33,27.15,710,891630,0.06
"8213",2018-12-27 14:57:03,27.2,1080,892710,0.09
"8113",2018-12-27 14:57:12,27.2,8230,900940,0.68
"8013",2018-12-27 14:57:17,27.2,710,901650,0.06
"7913",2018-12-27 14:58:15,27.25,1000,902650,0.08
"7813",2018-12-27 14:58:24,27.25,820,903470,0.07
"7713",2018-12-27 14:59:00,27.2,30,903500,0
"7613",2018-12-27 14:59:01,27.2,710,904210,0.06
"7513",2018-12-27 15:00:33,27.25,1080,905290,0.09
"7413",2018-12-27 15:01:13,27.2,710,906000,0.06
"7313",2018-12-27 15:01:55,27.2,5000,911000,0.41
"7213",2018-12-27 15:02:42,27.2,710,911710,0.06
"7113",2018-12-27 15:02:55,27.2,1080,912790,0.09
"7013",2018-12-27 15:03:13,27.2,10,912800,0
"6913",2018-12-27 15:03:42,27.2,100,912900,0.01
"6813",2018-12-27 15:04:03,27.25,1080,913980,0.09
"6713",2018-12-27 15:04:07,27.25,10,913990,0
"6613",2018-12-27 15:04:13,27.2,710,914700,0.06
"6513",2018-12-27 15:05:09,27.2,100,914800,0.01
"6413",2018-12-27 15:05:45,27.2,2000,916800,0.17
"6313",2018-12-27 15:05:59,27.15,710,917510,0.06
"6213",2018-12-27 15:06:44,27.15,400,917910,0.03
"6113",2018-12-27 15:07:36,27.25,1080,918990,0.09
"6013",2018-12-27 15:07:42,27.15,710,919700,0.06
"5913",2018-12-27 15:08:55,27.15,1000,920700,0.08
"5813",2018-12-27 15:08:58,27.15,30,920730,0
"5713",2018-12-27 15:09:26,27.15,710,921440,0.06
"5613",2018-12-27 15:09:51,27.15,510,921950,0.04
"5513",2018-12-27 15:11:03,27.2,1080,923030,0.09
"5416",2018-12-27 15:11:10,27.15,710,923740,0.06
"5318",2018-12-27 15:12:42,27.15,10,923750,0
"5218",2018-12-27 15:12:54,27.15,710,924460,0.06
"5118",2018-12-27 15:13:11,27.15,2000,926460,0.17
"5018",2018-12-27 15:13:23,27.15,1000,927460,0.08
"4919",2018-12-27 15:13:57,27.15,500,927960,0.04
"4819",2018-12-27 15:14:34,27.2,1080,929040,0.09
"4719",2018-12-27 15:14:38,27.15,710,929750,0.06
"4619",2018-12-27 15:15:51,27.15,1090,930840,0.09
"4519",2018-12-27 15:16:26,27.15,1000,931840,0.08
"4419",2018-12-27 15:16:31,27.15,710,932550,0.06
"4319",2018-12-27 15:16:33,27.15,500,933050,0.04
"4220",2018-12-27 15:16:55,27.15,15000,948050,1.24
"4120",2018-12-27 15:17:06,27.2,60,948110,0
"4020",2018-12-27 15:17:19,27.05,97700,1045810,8.1
"3920",2018-12-27 15:17:25,27.05,600,1046410,0.05
"3820",2018-12-27 15:17:48,27.05,500,1046910,0.04
"3726",2018-12-27 15:18:04,27.05,1080,1047990,0.09
"3626",2018-12-27 15:18:06,27,710,1048700,0.06
"3526",2018-12-27 15:18:12,27,100,1048800,0.01
"3428",2018-12-27 15:18:44,27.05,560,1049360,0.05
"3329",2018-12-27 15:19:30,27,10000,1059360,0.83
"3229",2018-12-27 15:19:50,27,710,1060070,0.06
"3130",2018-12-27 15:20:54,27.05,60,1060130,0
"3030",2018-12-27 15:21:33,27.1,1080,1061210,0.09
"2930",2018-12-27 15:21:34,27.05,710,1061920,0.06
"2830",2018-12-27 15:22:38,27.1,300,1062220,0.02
"2730",2018-12-27 15:22:51,27.05,2230,1064450,0.18
"2630",2018-12-27 15:23:11,27,1700,1066150,0.14
"2530",2018-12-27 15:23:18,27,710,1066860,0.06
"2430",2018-12-27 15:23:34,27,19900,1086760,1.65
"2330",2018-12-27 15:23:38,27,100,1086860,0.01
"2230",2018-12-27 15:24:10,27,2030,1088890,0.17
"2139",2018-12-27 15:24:19,27,1500,1090390,0.12
"2030",2018-12-27 15:24:20,27.05,150,1090540,0.01
"1930",2018-12-27 15:24:51,27,2000,1092540,0.17
"1830",2018-12-27 15:25:02,27,710,1093250,0.06
"1730",2018-12-27 15:25:03,27.05,1080,1094330,0.09
"1630",2018-12-27 15:25:49,27,16920,1111250,1.4
"1530",2018-12-27 15:25:50,27,200,1111450,0.02
"1430",2018-12-27 15:25:51,27,3390,1114840,0.28
"1330",2018-12-27 15:26:11,27.05,1240,1116080,0.1
"1230",2018-12-27 15:26:25,27.05,930,1117010,0.08
"1139",2018-12-27 15:26:56,27.05,20,1117030,0
"1030",2018-12-27 15:26:57,27.05,800,1117830,0.07
"930",2018-12-27 15:27:05,27.05,5000,1122830,0.41
"8103",2018-12-27 15:27:34,27,2000,1124830,0.17
"7103",2018-12-27 15:28:47,27.05,1000,1125830,0.08
"6103",2018-12-27 15:29:11,27.05,10,1125840,0
"5103",2018-12-27 15:29:27,27.05,2000,1127840,0.17
"4124",2018-12-27 15:29:29,27.05,5000,1132840,0.41
"3138",2018-12-27 15:29:39,27.05,400,1133240,0.03
"2140",2018-12-27 15:29:46,27.05,2000,1135240,0.17
"1140",2018-12-27 15:46:18,27,71090,1206330,5.89
"4174",2019-01-04 10:15:35,26,39660,39660,3.22
"4164",2019-01-04 10:16:00,26,22400,62060,1.82
"4154",2019-01-04 10:16:06,26,9990,72050,0.81
"4144",2019-01-04 10:16:08,26,1000,73050,0.08
"4134",2019-01-04 10:16:18,26,5000,78050,0.41
"4125",2019-01-04 10:16:23,26,900,78950,0.07
"41110",2019-01-04 10:16:24,26,500,79450,0.04
"41010",2019-01-04 10:16:27,26,20840,100290,1.69
"4094",2019-01-04 10:16:34,26,500,100790,0.04
"4084",2019-01-04 10:17:04,25.95,50,100840,0
"4074",2019-01-04 10:17:51,25.95,100,100940,0.01
"4064",2019-01-04 10:18:09,25.65,300,101240,0.02
"4054",2019-01-04 10:18:17,25.75,10,101250,0
"4044",2019-01-04 10:18:51,25.95,300,101550,0.02
"4034",2019-01-04 10:18:57,25.75,60,101610,0
"4024",2019-01-04 10:19:32,25.75,10,101620,0
"40110",2019-01-04 10:19:46,25.75,340,101960,0.03
"4004",2019-01-04 10:21:59,25.7,10,101970,0
"3994",2019-01-04 10:22:19,25.7,470,102440,0.04
"3984",2019-01-04 10:22:36,25.7,100,102540,0.01
"3974",2019-01-04 10:23:02,25.7,500,103040,0.04
"3964",2019-01-04 10:23:16,25.65,1000,104040,0.08
"3954",2019-01-04 10:23:50,25.65,80,104120,0.01
"3944",2019-01-04 10:23:51,25.7,100,104220,0.01
"3934",2019-01-04 10:24:32,25.65,9520,113740,0.77
"3924",2019-01-04 10:24:45,25.65,300,114040,0.02
"39110",2019-01-04 10:25:06,25.6,1000,115040,0.08
"3904",2019-01-04 10:26:25,25.6,200,115240,0.02
"3894",2019-01-04 10:26:34,25.6,500,115740,0.04
"3884",2019-01-04 10:26:37,25.6,400,116140,0.03
"3874",2019-01-04 10:26:52,25.6,200,116340,0.02
"3864",2019-01-04 10:27:08,25.6,150,116490,0.01
"3854",2019-01-04 10:27:26,25.6,2000,118490,0.16
"3844",2019-01-04 10:27:32,25.6,3000,121490,0.24
"3834",2019-01-04 10:27:34,25.6,690,122180,0.06
"3825",2019-01-04 10:27:54,25.6,100,122280,0.01
"38111",2019-01-04 10:28:02,25.6,480,122760,0.04
"3805",2019-01-04 10:28:13,25.6,5000,127760,0.41
"3795",2019-01-04 10:28:28,25.65,800,128560,0.06
"3785",2019-01-04 10:28:29,25.55,2000,130560,0.16
"3776",2019-01-04 10:28:43,25.55,300,130860,0.02
"3766",2019-01-04 10:28:52,25.5,20000,150860,1.62
"3756",2019-01-04 10:29:01,25.6,1510,152370,0.12
"3746",2019-01-04 10:29:07,25.6,5000,157370,0.41
"3736",2019-01-04 10:29:13,25.5,20000,177370,1.62
"3727",2019-01-04 10:29:32,25.45,23800,201170,1.93
"37111",2019-01-04 10:29:36,25.45,6000,207170,0.49
"3706",2019-01-04 10:29:37,25.5,100,207270,0.01
"3696",2019-01-04 10:29:39,25.5,2000,209270,0.16
"3686",2019-01-04 10:29:43,25.5,3900,213170,0.32
"3676",2019-01-04 10:29:56,25.55,50,213220,0
"3666",2019-01-04 10:30:01,25.5,5000,218220,0.41
"3656",2019-01-04 10:30:33,25.5,6000,224220,0.49
"3646",2019-01-04 10:30:41,25.5,300,224520,0.02
"3636",2019-01-04 10:31:01,25.5,50,224570,0
"3627",2019-01-04 10:31:12,25.5,460,225030,0.04
"36111",2019-01-04 10:31:14,25.5,540,225570,0.04
"3606",2019-01-04 10:31:42,25.55,4950,230520,0.4
"3596",2019-01-04 10:31:44,25.55,600,231120,0.05
"3586",2019-01-04 10:31:47,25.6,830,231950,0.07
"3576",2019-01-04 10:32:00,25.55,4000,235950,0.32
"3566",2019-01-04 10:32:13,25.6,60,236010,0
"3556",2019-01-04 10:32:48,25.6,100,236110,0.01
"3546",2019-01-04 10:32:58,25.6,50,236160,0
"3536",2019-01-04 10:34:11,25.6,500,236660,0.04
"3527",2019-01-04 10:34:58,25.55,1000,237660,0.08
"35111",2019-01-04 10:35:39,25.6,100,237760,0.01
"3506",2019-01-04 10:36:19,25.55,300,238060,0.02
"3497",2019-01-04 10:36:37,25.55,500,238560,0.04
"3487",2019-01-04 10:36:38,25.55,2800,241360,0.23
"3477",2019-01-04 10:37:11,25.55,100,241460,0.01
"3467",2019-01-04 10:37:34,25.55,500,241960,0.04
"3457",2019-01-04 10:37:58,25.55,450,242410,0.04
"3447",2019-01-04 10:38:08,25.55,20,242430,0
"3437",2019-01-04 10:38:43,25.5,510,242940,0.04
"3429",2019-01-04 10:38:55,25.5,20,242960,0
"34112",2019-01-04 10:38:58,25.5,500,243460,0.04
"3408",2019-01-04 10:39:32,25.5,4740,248200,0.38
"3398",2019-01-04 10:39:39,25.5,5000,253200,0.41
"3388",2019-01-04 10:39:54,25.5,2000,255200,0.16
"3378",2019-01-04 10:40:37,25.5,4740,259940,0.38
"3368",2019-01-04 10:41:39,25.5,1000,260940,0.08
"3358",2019-01-04 10:41:47,25.5,3000,263940,0.24
"3348",2019-01-04 10:42:05,25.55,200,264140,0.02
"3338",2019-01-04 10:42:08,25.5,2000,266140,0.16
"33210",2019-01-04 10:42:18,25.5,100,266240,0.01
"33112",2019-01-04 10:42:33,25.5,370,266610,0.03
"3308",2019-01-04 10:43:02,25.5,200,266810,0.02
"3298",2019-01-04 10:43:16,25.5,360,267170,0.03
"3288",2019-01-04 10:43:23,25.5,100,267270,0.01
"3278",2019-01-04 10:43:24,25.6,17600,284870,1.43
"3268",2019-01-04 10:45:52,25.5,1000,285870,0.08
"3258",2019-01-04 10:46:23,25.5,2000,287870,0.16
"3248",2019-01-04 10:46:42,25.55,3500,291370,0.28
"3238",2019-01-04 10:47:05,25.55,1500,292870,0.12
"32210",2019-01-04 10:47:14,25.55,500,293370,0.04
"32112",2019-01-04 10:47:16,25.6,100,293470,0.01
"3208",2019-01-04 10:48:29,25.5,10000,303470,0.81
"3198",2019-01-04 10:48:46,25.55,10,303480,0
"3188",2019-01-04 10:49:12,25.55,90,303570,0.01
"3178",2019-01-04 10:49:17,25.55,110,303680,0.01
"3168",2019-01-04 10:49:26,25.55,90,303770,0.01
"3158",2019-01-04 10:49:31,25.55,300,304070,0.02
"3148",2019-01-04 10:49:35,25.55,3280,307350,0.27
"3139",2019-01-04 10:49:48,25.55,200,307550,0.02
"31211",2019-01-04 10:50:16,25.55,500,308050,0.04
"31112",2019-01-04 10:50:43,25.6,10000,318050,0.81
"31012",2019-01-04 10:50:48,25.6,2000,320050,0.16
"3098",2019-01-04 10:50:50,25.6,8150,328200,0.66
"3088",2019-01-04 10:51:14,25.6,10000,338200,0.81
"3078",2019-01-04 10:51:27,25.65,3000,341200,0.24
"3068",2019-01-04 10:51:59,25.65,160,341360,0.01
"3059",2019-01-04 10:52:01,25.65,390,341750,0.03
"3049",2019-01-04 10:52:44,25.6,1750,343500,0.14
"3039",2019-01-04 10:53:03,25.65,100,343600,0.01
"30210",2019-01-04 10:53:07,25.6,200,343800,0.02
"30113",2019-01-04 10:53:29,25.6,510,344310,0.04
"3009",2019-01-04 10:53:37,25.6,2690,347000,0.22
"2999",2019-01-04 10:54:06,25.65,10000,357000,0.81
"2989",2019-01-04 10:54:24,25.65,4350,361350,0.35
"2979",2019-01-04 10:55:24,25.7,5000,366350,0.41
"2969",2019-01-04 10:55:29,25.7,90,366440,0.01
"2959",2019-01-04 10:55:34,25.65,400,366840,0.03
"2949",2019-01-04 10:55:54,25.7,100,366940,0.01
"2939",2019-01-04 10:56:26,25.7,110,367050,0.01
"29210",2019-01-04 10:56:28,25.65,5000,372050,0.41
"29113",2019-01-04 10:56:32,25.65,430,372480,0.03
"2909",2019-01-04 10:57:14,25.7,10,372490,0
"2899",2019-01-04 10:57:41,25.7,1000,373490,0.08
"2889",2019-01-04 10:58:17,25.7,500,373990,0.04
"2879",2019-01-04 10:58:26,25.7,2000,375990,0.16
"2869",2019-01-04 10:58:42,25.7,3010,379000,0.24
"2859",2019-01-04 10:58:54,25.7,1000,380000,0.08
"2849",2019-01-04 10:58:58,25.7,1100,381100,0.09
"2839",2019-01-04 10:59:07,25.7,10000,391100,0.81
"28210",2019-01-04 10:59:11,25.7,2000,393100,0.16
"28113",2019-01-04 10:59:12,25.7,1780,394880,0.14
"2809",2019-01-04 10:59:23,25.75,560,395440,0.05
"2799",2019-01-04 10:59:36,25.75,100,395540,0.01
"2789",2019-01-04 10:59:55,25.75,8340,403880,0.68
"2779",2019-01-04 11:00:18,25.7,5000,408880,0.41
"2769",2019-01-04 11:01:28,25.7,8820,417700,0.72
"2759",2019-01-04 11:01:45,25.7,300,418000,0.02
"2749",2019-01-04 11:02:00,25.7,3360,421360,0.27
"2739",2019-01-04 11:02:18,25.75,1000,422360,0.08
"27210",2019-01-04 11:03:22,25.75,2560,424920,0.21
"27113",2019-01-04 11:03:23,25.75,1310,426230,0.11
"2709",2019-01-04 11:03:46,25.75,1000,427230,0.08
"2699",2019-01-04 11:04:33,25.75,1160,428390,0.09
"2689",2019-01-04 11:05:02,25.75,2000,430390,0.16
"2679",2019-01-04 11:05:03,25.75,10,430400,0
"2669",2019-01-04 11:05:08,25.75,830,431230,0.07
"2659",2019-01-04 11:05:21,25.75,200,431430,0.02
"2649",2019-01-04 11:05:24,25.75,4980,436410,0.4
"2639",2019-01-04 11:05:32,25.75,20,436430,0
"26210",2019-01-04 11:05:54,25.75,1090,437520,0.09
"26113",2019-01-04 11:06:08,25.75,4000,441520,0.32
"2609",2019-01-04 11:06:46,25.75,1000,442520,0.08
"2599",2019-01-04 11:07:38,25.75,410,442930,0.03
"2589",2019-01-04 11:07:45,25.75,20,442950,0
"2579",2019-01-04 11:07:58,25.75,220,443170,0.02
"2569",2019-01-04 11:08:04,25.7,10,443180,0
"2559",2019-01-04 11:08:15,25.7,8000,451180,0.65
"2549",2019-01-04 11:08:39,25.7,100,451280,0.01
"2539",2019-01-04 11:09:06,25.7,10000,461280,0.81
"25210",2019-01-04 11:09:10,25.7,5000,466280,0.41
"25113",2019-01-04 11:09:12,25.7,250,466530,0.02
"2509",2019-01-04 11:09:25,25.7,5000,471530,0.41
"2499",2019-01-04 11:09:35,25.7,3500,475030,0.28
"2489",2019-01-04 11:09:44,25.75,2000,477030,0.16
"2479",2019-01-04 11:10:06,25.75,10,477040,0
"2469",2019-01-04 11:11:09,25.7,17090,494130,1.39
"2459",2019-01-04 11:11:56,25.65,13800,507930,1.12
"2449",2019-01-04 11:12:29,25.7,12710,520640,1.03
"2439",2019-01-04 11:13:23,25.7,3370,524010,0.27
"24210",2019-01-04 11:13:37,25.75,10,524020,0
"24113",2019-01-04 11:14:09,25.75,8400,532420,0.68
"2409",2019-01-04 11:15:03,25.75,10000,542420,0.81
"2399",2019-01-04 11:15:20,25.75,50,542470,0
"2389",2019-01-04 11:16:26,25.75,500,542970,0.04
"2379",2019-01-04 11:16:28,25.7,1000,543970,0.08
"2369",2019-01-04 11:17:22,25.7,720,544690,0.06
"2359",2019-01-04 11:18:35,25.7,1000,545690,0.08
"2349",2019-01-04 11:18:40,25.7,5000,550690,0.41
"2339",2019-01-04 11:18:41,25.7,1000,551690,0.08
"23210",2019-01-04 11:19:33,25.7,320,552010,0.03
"23113",2019-01-04 11:19:42,25.7,5000,557010,0.41
"2309",2019-01-04 11:20:30,25.7,2900,559910,0.24
"2299",2019-01-04 11:20:42,25.7,8000,567910,0.65
"2289",2019-01-04 11:20:46,25.7,30,567940,0
"2279",2019-01-04 11:22:21,25.65,50,567990,0
"2269",2019-01-04 11:22:29,25.65,9480,577470,0.77
"2259",2019-01-04 11:23:40,25.7,3970,581440,0.32
"2249",2019-01-04 11:24:16,25.7,6000,587440,0.49
"2239",2019-01-04 11:24:27,25.7,10000,597440,0.81
"22210",2019-01-04 11:24:46,25.7,30,597470,0
"22113",2019-01-04 11:26:25,25.65,4970,602440,0.4
"2209",2019-01-04 11:27:44,25.7,20,602460,0
"2199",2019-01-04 11:28:40,25.65,2980,605440,0.24
"2189",2019-01-04 11:29:06,25.7,50,605490,0
"2179",2019-01-04 11:29:58,25.65,5000,610490,0.41
"2169",2019-01-04 11:31:25,25.65,1000,611490,0.08
"2159",2019-01-04 11:32:49,25.65,70,611560,0.01
"2149",2019-01-04 11:35:30,25.7,5000,616560,0.41
"21310",2019-01-04 11:35:41,25.7,1570,618130,0.13
"21211",2019-01-04 11:36:05,25.7,3100,621230,0.25
"21113",2019-01-04 11:36:11,25.75,1330,622560,0.11
"21013",2019-01-04 11:37:20,25.75,200,622760,0.02
"2099",2019-01-04 11:38:12,25.75,300,623060,0.02
"2089",2019-01-04 11:38:33,25.8,1000,624060,0.08
"2079",2019-01-04 11:38:42,25.8,6000,630060,0.49
"2069",2019-01-04 11:41:13,25.8,2600,632660,0.21
"2059",2019-01-04 11:41:54,25.8,200,632860,0.02
"2049",2019-01-04 11:43:04,25.8,1100,633960,0.09
"2039",2019-01-04 11:43:56,25.85,3360,637320,0.27
"20210",2019-01-04 11:45:05,25.85,1140,638460,0.09
"20113",2019-01-04 11:46:16,25.9,8000,646460,0.65
"2009",2019-01-04 11:46:23,25.9,100,646560,0.01
"1999",2019-01-04 11:48:27,25.9,500,647060,0.04
"1989",2019-01-04 11:50:01,25.85,4830,651890,0.39
"1979",2019-01-04 11:50:09,25.85,100,651990,0.01
"1969",2019-01-04 11:51:15,25.85,70,652060,0.01
"1959",2019-01-04 11:51:30,25.95,4000,656060,0.32
"1949",2019-01-04 11:53:33,25.95,10,656070,0
"1939",2019-01-04 11:54:21,25.95,4790,660860,0.39
"19210",2019-01-04 11:54:33,25.95,210,661070,0.02
"19113",2019-01-04 11:55:40,25.9,2000,663070,0.16
"1909",2019-01-04 11:56:38,25.95,5000,668070,0.41
"1899",2019-01-04 11:56:59,25.95,4800,672870,0.39
"1889",2019-01-04 11:57:04,25.95,1000,673870,0.08
"1879",2019-01-04 11:57:19,25.95,5000,678870,0.41
"1869",2019-01-04 11:57:48,25.95,2500,681370,0.2
"1859",2019-01-04 11:57:55,25.95,470,681840,0.04
"1849",2019-01-04 11:59:22,26,30,681870,0
"1839",2019-01-04 11:59:35,26,1000,682870,0.08
"18210",2019-01-04 11:59:40,26,135000,817870,10.95
"18113",2019-01-04 11:59:59,26.05,10,817880,0
"1809",2019-01-04 12:00:41,26.1,10000,827880,0.81
"1799",2019-01-04 12:00:51,26.1,10,827890,0
"1789",2019-01-04 12:01:51,26.1,30,827920,0
"1779",2019-01-04 12:02:03,26.1,100,828020,0.01
"1769",2019-01-04 12:02:17,26.1,50,828070,0
"1759",2019-01-04 12:03:01,26.1,500,828570,0.04
"1749",2019-01-04 12:03:22,26.1,80,828650,0.01
"1739",2019-01-04 12:04:38,26.2,9000,837650,0.73
"17210",2019-01-04 12:04:59,26.2,450,838100,0.04
"17113",2019-01-04 12:05:33,26.2,15000,853100,1.22
"1709",2019-01-04 12:05:50,26.2,1570,854670,0.13
"1699",2019-01-04 12:05:55,26.2,50,854720,0
"1689",2019-01-04 12:05:59,26.2,990,855710,0.08
"1679",2019-01-04 12:06:24,26.2,3000,858710,0.24
"1669",2019-01-04 12:06:58,26.2,3100,861810,0.25
"1659",2019-01-04 12:07:15,26.2,2910,864720,0.24
"1649",2019-01-04 12:08:09,26.2,100,864820,0.01
"1639",2019-01-04 12:09:20,26.2,200,865020,0.02
"16210",2019-01-04 12:11:23,26.2,1900,866920,0.15
"16113",2019-01-04 12:11:27,26.1,60,866980,0
"1609",2019-01-04 12:11:56,26.1,180,867160,0.01
"1599",2019-01-04 12:12:30,26.1,100,867260,0.01
"1589",2019-01-04 12:12:43,26.1,1000,868260,0.08
"1579",2019-01-04 12:12:47,26.1,20,868280,0
"1569",2019-01-04 12:13:00,26.1,500,868780,0.04
"1559",2019-01-04 12:13:01,26.1,5000,873780,0.41
"1549",2019-01-04 12:13:07,26.1,200,873980,0.02
"1539",2019-01-04 12:13:10,26.1,100,874080,0.01
"15210",2019-01-04 12:13:47,26.1,120,874200,0.01
"15113",2019-01-04 12:14:37,26,5000,879200,0.41
"1509",2019-01-04 12:15:27,26,3000,882200,0.24
"1499",2019-01-04 12:15:35,26,1200,883400,0.1
"1489",2019-01-04 12:15:44,26,500,883900,0.04
"1479",2019-01-04 12:16:19,26,200,884100,0.02
"1469",2019-01-04 12:17:38,25.95,350,884450,0.03
"1459",2019-01-04 12:18:02,25.95,810,885260,0.07
"1449",2019-01-04 12:18:19,25.9,2690,887950,0.22
"1439",2019-01-04 12:18:46,26,10,887960,0
"14210",2019-01-04 12:19:37,26,7440,895400,0.6
"14113",2019-01-04 12:20:54,25.85,5000,900400,0.41
"1409",2019-01-04 12:21:43,26,20,900420,0
"1399",2019-01-04 12:24:42,26,3440,903860,0.28
"1389",2019-01-04 12:26:12,26.1,750,904610,0.06
"1379",2019-01-04 12:26:44,26.1,200,904810,0.02
"1369",2019-01-04 12:27:51,26.1,1250,906060,0.1
"1359",2019-01-04 12:28:09,26.1,3000,909060,0.24
"1349",2019-01-04 12:29:14,26.1,1000,910060,0.08
"1339",2019-01-04 12:29:21,26.1,5000,915060,0.41
"13210",2019-01-04 12:29:51,26.1,500,915560,0.04
"13113",2019-01-04 14:01:09,26.1,1920,917480,0.16
"1309",2019-01-04 14:02:14,26,60,917540,0
"1299",2019-01-04 14:04:15,26.05,100,917640,0.01
"1289",2019-01-04 14:06:47,26,20,917660,0
"1279",2019-01-04 14:07:50,26,600,918260,0.05
"1269",2019-01-04 14:08:02,26,500,918760,0.04
"1259",2019-01-04 14:08:10,26,210,918970,0.02
"1249",2019-01-04 14:08:41,26,290,919260,0.02
"1239",2019-01-04 14:08:55,26,500,919760,0.04
"12210",2019-01-04 14:10:02,26,100,919860,0.01
"12113",2019-01-04 14:10:12,26,110,919970,0.01
"1209",2019-01-04 14:11:34,25.95,4740,924710,0.38
"1199",2019-01-04 14:12:27,25.95,260,924970,0.02
"1189",2019-01-04 14:12:54,25.95,30,925000,0
"1179",2019-01-04 14:14:23,25.95,4450,929450,0.36
"1169",2019-01-04 14:15:25,26,30,929480,0
"1159",2019-01-04 14:16:40,26,200,929680,0.02
"1149",2019-01-04 14:18:03,26,50,929730,0
"11310",2019-01-04 14:18:27,25.95,1550,931280,0.13
"11211",2019-01-04 14:19:03,25.95,20,931300,0
"11113",2019-01-04 14:19:09,25.95,50,931350,0
"11013",2019-01-04 14:19:27,25.95,3380,934730,0.27
"1099",2019-01-04 14:19:48,26,1000,935730,0.08
"1089",2019-01-04 14:20:26,26,100,935830,0.01
"1079",2019-01-04 14:20:31,25.95,6000,941830,0.49
"1069",2019-01-04 14:21:22,26,100,941930,0.01
"1059",2019-01-04 14:21:58,26,710,942640,0.06
"1049",2019-01-04 14:22:40,26.05,140,942780,0.01
"1039",2019-01-04 14:22:53,26.05,200,942980,0.02
"10210",2019-01-04 14:23:23,26,5000,947980,0.41
"10113",2019-01-04 14:24:02,26,100,948080,0.01
"1009",2019-01-04 14:24:40,26,5000,953080,0.41
"999",2019-01-04 14:25:17,26,100,953180,0.01
"989",2019-01-04 14:25:38,26,650,953830,0.05
"979",2019-01-04 14:25:44,26.05,160,953990,0.01
"969",2019-01-04 14:25:50,26,10,954000,0
"959",2019-01-04 14:26:51,26,1000,955000,0.08
"949",2019-01-04 14:27:17,26,350,955350,0.03
"939",2019-01-04 14:28:55,26,1000,956350,0.08
"9210",2019-01-04 14:29:12,26,10300,966650,0.84
"9113",2019-01-04 14:29:16,26,4180,970830,0.34
"909",2019-01-04 14:29:21,26,3420,974250,0.28
"8914",2019-01-04 14:29:36,26,4000,978250,0.32
"8814",2019-01-04 14:29:59,26,2000,980250,0.16
"8714",2019-01-04 14:30:27,26,790,981040,0.06
"8614",2019-01-04 14:30:56,26.05,2000,983040,0.16
"8514",2019-01-04 14:31:56,26.05,9280,992320,0.75
"8414",2019-01-04 14:32:41,26.1,10,992330,0
"8314",2019-01-04 14:33:17,26.05,720,993050,0.06
"8214",2019-01-04 14:33:43,26.05,6280,999330,0.51
"8114",2019-01-04 14:34:38,26.05,3000,1002330,0.24
"8014",2019-01-04 14:37:58,26.05,3200,1005530,0.26
"7914",2019-01-04 14:38:20,26.1,950,1006480,0.08
"7814",2019-01-04 14:38:43,26.1,2000,1008480,0.16
"7714",2019-01-04 14:39:20,26.1,620,1009100,0.05
"7614",2019-01-04 14:39:39,26.1,5000,1014100,0.41
"7514",2019-01-04 14:39:42,26.05,6000,1020100,0.49
"7414",2019-01-04 14:39:53,26.05,2000,1022100,0.16
"7314",2019-01-04 14:40:35,26.05,100,1022200,0.01
"7214",2019-01-04 14:41:53,26.05,700,1022900,0.06
"7114",2019-01-04 14:42:03,26.05,1600,1024500,0.13
"7014",2019-01-04 14:42:51,26.05,70,1024570,0.01
"6914",2019-01-04 14:43:32,26.05,600,1025170,0.05
"6814",2019-01-04 14:44:40,26.1,100,1025270,0.01
"6714",2019-01-04 14:44:58,26.05,5000,1030270,0.41
"6614",2019-01-04 14:45:28,26.1,3000,1033270,0.24
"6514",2019-01-04 14:46:23,26.1,500,1033770,0.04
"6414",2019-01-04 14:48:11,26,4000,1037770,0.32
"6314",2019-01-04 14:49:57,26.1,10,1037780,0
"6214",2019-01-04 14:50:18,26.1,200,1037980,0.02
"6114",2019-01-04 14:51:06,26.1,1000,1038980,0.08
"6014",2019-01-04 14:52:39,26.1,10130,1049110,0.82
"5914",2019-01-04 14:53:09,26.15,3070,1052180,0.25
"5814",2019-01-04 14:53:58,26.2,2000,1054180,0.16
"5714",2019-01-04 14:54:57,26.15,200,1054380,0.02
"5614",2019-01-04 14:56:15,26.15,210,1054590,0.02
"5514",2019-01-04 14:57:04,26.15,790,1055380,0.06
"5417",2019-01-04 14:57:37,26.1,4000,1059380,0.32
"5319",2019-01-04 14:57:43,26.2,1000,1060380,0.08
"5219",2019-01-04 14:58:19,26.2,3000,1063380,0.24
"5119",2019-01-04 14:58:26,26.2,40,1063420,0
"5019",2019-01-04 14:59:38,26.15,2000,1065420,0.16
"4920",2019-01-04 15:02:15,26.15,650,1066070,0.05
"4820",2019-01-04 15:03:31,26.2,2000,1068070,0.16
"4720",2019-01-04 15:03:44,26.2,50,1068120,0
"4620",2019-01-04 15:03:50,26.2,2000,1070120,0.16
"4520",2019-01-04 15:04:19,26.15,10,1070130,0
"4420",2019-01-04 15:04:59,26.15,6100,1076230,0.49
"4320",2019-01-04 15:05:27,26.1,5000,1081230,0.41
"4224",2019-01-04 15:06:06,26.15,4900,1086130,0.4
"4126",2019-01-04 15:06:14,26.1,50,1086180,0
"4025",2019-01-04 15:07:15,26.1,400,1086580,0.03
"3925",2019-01-04 15:09:04,26.15,2100,1088680,0.17
"3826",2019-01-04 15:09:50,26.2,1800,1090480,0.15
"3728",2019-01-04 15:10:23,26.2,1000,1091480,0.08
"3628",2019-01-04 15:10:39,26.2,4020,1095500,0.33
"3528",2019-01-04 15:10:49,26.2,5000,1100500,0.41
"3430",2019-01-04 15:11:31,26.2,1900,1102400,0.15
"3330",2019-01-04 15:12:44,26.1,30000,1132400,2.43
"3230",2019-01-04 15:12:55,26.1,5000,1137400,0.41
"3140",2019-01-04 15:13:05,26.1,3000,1140400,0.24
"3040",2019-01-04 15:13:51,26.1,20,1140420,0
"2940",2019-01-04 15:14:10,26.15,100,1140520,0.01
"2840",2019-01-04 15:15:16,26.15,150,1140670,0.01
"2740",2019-01-04 15:16:17,26.15,500,1141170,0.04
"2640",2019-01-04 15:17:09,26.15,100,1141270,0.01
"2540",2019-01-04 15:17:42,26.1,1000,1142270,0.08
"2440",2019-01-04 15:18:13,26.1,5000,1147270,0.41
"2340",2019-01-04 15:18:16,26.1,20,1147290,0
"2240",2019-01-04 15:19:21,26.2,2000,1149290,0.16
"2150",2019-01-04 15:21:00,26.1,3000,1152290,0.24
"2040",2019-01-04 15:22:19,26.1,220,1152510,0.02
"1940",2019-01-04 15:22:24,26.1,3800,1156310,0.31
"1840",2019-01-04 15:23:00,26.1,980,1157290,0.08
"1740",2019-01-04 15:23:16,26.1,340,1157630,0.03
"1640",2019-01-04 15:23:30,26.1,200,1157830,0.02
"1540",2019-01-04 15:24:22,26.1,1000,1158830,0.08
"1440",2019-01-04 15:24:34,26.1,11400,1170230,0.92
"1340",2019-01-04 15:24:51,26.05,5000,1175230,0.41
"1240",2019-01-04 15:25:05,26,2000,1177230,0.16
"1150",2019-01-04 15:26:11,26.1,3000,1180230,0.24
"1040",2019-01-04 15:26:25,26.1,850,1181080,0.07
"940",2019-01-04 15:26:28,26.1,1790,1182870,0.15
"8104",2019-01-04 15:26:41,26.1,4410,1187280,0.36
"7104",2019-01-04 15:26:47,26,5000,1192280,0.41
"6104",2019-01-04 15:27:08,26,10,1192290,0
"5104",2019-01-04 15:29:25,26,5000,1197290,0.41
"4127",2019-01-04 15:29:41,26,50,1197340,0
"3149",2019-01-04 15:29:43,26,100,1197440,0.01
"2160",2019-01-04 15:30:03,26,1000,1198440,0.08
"1160",2019-01-04 15:46:23,26,34470,1232910,2.8
